Name	Sequence	Count
KRS1TTT	TATGAAATTGGTAAATTTTTTAGAAATGAAGGTATAGATAATACACATAATCCTGAATTTACTTCGTGTGAATTTTATTGGGCATATGCT	9014
KRS1TTC	TATGAAATTGGTAAATTCTTTAGAAATGAAGGTATAGATAATACACATAATCCTGAATTTACTTCGTGTGAATTTTATTGGGCATATGCT	27
KRS1TTA	TATGAAATTGGTAAATTATTTAGAAATGAAGGTATAGATAATACACATAATCCTGAATTTACTTCGTGTGAATTTTATTGGGCATATGCT	17
KRS1TTG	TATGAAATTGGTAAATTGTTTAGAAATGAAGGTATAGATAATACACATAATCCTGAATTTACTTCGTGTGAATTTTATTGGGCATATGCT	503
KRS1CTT	TATGAAATTGGTAAACTTTTTAGAAATGAAGGTATAGATAATACACATAATCCTGAATTTACTTCGTGTGAATTTTATTGGGCATATGCT	17501
KRS1CTC	TATGAAATTGGTAAACTCTTTAGAAATGAAGGTATAGATAATACACATAATCCTGAATTTACTTCGTGTGAATTTTATTGGGCATATGCT	64
KRS1CTA	TATGAAATTGGTAAACTATTTAGAAATGAAGGTATAGATAATACACATAATCCTGAATTTACTTCGTGTGAATTTTATTGGGCATATGCT	44
KRS1CTG	TATGAAATTGGTAAACTGTTTAGAAATGAAGGTATAGATAATACACATAATCCTGAATTTACTTCGTGTGAATTTTATTGGGCATATGCT	9
KRS1ATT	TATGAAATTGGTAAAATTTTTAGAAATGAAGGTATAGATAATACACATAATCCTGAATTTACTTCGTGTGAATTTTATTGGGCATATGCT	24
KRS1ATC	TATGAAATTGGTAAAATCTTTAGAAATGAAGGTATAGATAATACACATAATCCTGAATTTACTTCGTGTGAATTTTATTGGGCATATGCT	22
KRS1ATA	TATGAAATTGGTAAAATATTTAGAAATGAAGGTATAGATAATACACATAATCCTGAATTTACTTCGTGTGAATTTTATTGGGCATATGCT	26
KRS1ATG	TATGAAATTGGTAAAATGTTTAGAAATGAAGGTATAGATAATACACATAATCCTGAATTTACTTCGTGTGAATTTTATTGGGCATATGCT	2
KRS1GTT	TATGAAATTGGTAAAGTTTTTAGAAATGAAGGTATAGATAATACACATAATCCTGAATTTACTTCGTGTGAATTTTATTGGGCATATGCT	120
KRS1GTC	TATGAAATTGGTAAAGTCTTTAGAAATGAAGGTATAGATAATACACATAATCCTGAATTTACTTCGTGTGAATTTTATTGGGCATATGCT	187
KRS1GTA	TATGAAATTGGTAAAGTATTTAGAAATGAAGGTATAGATAATACACATAATCCTGAATTTACTTCGTGTGAATTTTATTGGGCATATGCT	40702
KRS1GTG	TATGAAATTGGTAAAGTGTTTAGAAATGAAGGTATAGATAATACACATAATCCTGAATTTACTTCGTGTGAATTTTATTGGGCATATGCT	114
KRS1TCT	TATGAAATTGGTAAATCTTTTAGAAATGAAGGTATAGATAATACACATAATCCTGAATTTACTTCGTGTGAATTTTATTGGGCATATGCT	7787
KRS1TCC	TATGAAATTGGTAAATCCTTTAGAAATGAAGGTATAGATAATACACATAATCCTGAATTTACTTCGTGTGAATTTTATTGGGCATATGCT	157
KRS1TCA	TATGAAATTGGTAAATCATTTAGAAATGAAGGTATAGATAATACACATAATCCTGAATTTACTTCGTGTGAATTTTATTGGGCATATGCT	282
KRS1TCG	TATGAAATTGGTAAATCGTTTAGAAATGAAGGTATAGATAATACACATAATCCTGAATTTACTTCGTGTGAATTTTATTGGGCATATGCT	103492
KRS1CCT	TATGAAATTGGTAAACCTTTTAGAAATGAAGGTATAGATAATACACATAATCCTGAATTTACTTCGTGTGAATTTTATTGGGCATATGCT	76
KRS1CCC	TATGAAATTGGTAAACCCTTTAGAAATGAAGGTATAGATAATACACATAATCCTGAATTTACTTCGTGTGAATTTTATTGGGCATATGCT	228
KRS1CCA	TATGAAATTGGTAAACCATTTAGAAATGAAGGTATAGATAATACACATAATCCTGAATTTACTTCGTGTGAATTTTATTGGGCATATGCT	2
KRS1CCG	TATGAAATTGGTAAACCGTTTAGAAATGAAGGTATAGATAATACACATAATCCTGAATTTACTTCGTGTGAATTTTATTGGGCATATGCT	176
KRS1ACT	TATGAAATTGGTAAAACTTTTAGAAATGAAGGTATAGATAATACACATAATCCTGAATTTACTTCGTGTGAATTTTATTGGGCATATGCT	9
KRS1ACC	TATGAAATTGGTAAAACCTTTAGAAATGAAGGTATAGATAATACACATAATCCTGAATTTACTTCGTGTGAATTTTATTGGGCATATGCT	4
KRS1ACA	TATGAAATTGGTAAAACATTTAGAAATGAAGGTATAGATAATACACATAATCCTGAATTTACTTCGTGTGAATTTTATTGGGCATATGCT	8
KRS1ACG	TATGAAATTGGTAAAACGTTTAGAAATGAAGGTATAGATAATACACATAATCCTGAATTTACTTCGTGTGAATTTTATTGGGCATATGCT	127
KRS1GCT	TATGAAATTGGTAAAGCTTTTAGAAATGAAGGTATAGATAATACACATAATCCTGAATTTACTTCGTGTGAATTTTATTGGGCATATGCT	35
KRS1GCC	TATGAAATTGGTAAAGCCTTTAGAAATGAAGGTATAGATAATACACATAATCCTGAATTTACTTCGTGTGAATTTTATTGGGCATATGCT	5
KRS1GCA	TATGAAATTGGTAAAGCATTTAGAAATGAAGGTATAGATAATACACATAATCCTGAATTTACTTCGTGTGAATTTTATTGGGCATATGCT	38
KRS1GCG	TATGAAATTGGTAAAGCGTTTAGAAATGAAGGTATAGATAATACACATAATCCTGAATTTACTTCGTGTGAATTTTATTGGGCATATGCT	42
KRS1TAT	TATGAAATTGGTAAATATTTTAGAAATGAAGGTATAGATAATACACATAATCCTGAATTTACTTCGTGTGAATTTTATTGGGCATATGCT	13
KRS1TAC	TATGAAATTGGTAAATACTTTAGAAATGAAGGTATAGATAATACACATAATCCTGAATTTACTTCGTGTGAATTTTATTGGGCATATGCT	8
KRS1TAA	TATGAAATTGGTAAATAATTTAGAAATGAAGGTATAGATAATACACATAATCCTGAATTTACTTCGTGTGAATTTTATTGGGCATATGCT	0
KRS1TAG	TATGAAATTGGTAAATAGTTTAGAAATGAAGGTATAGATAATACACATAATCCTGAATTTACTTCGTGTGAATTTTATTGGGCATATGCT	12
KRS1CAT	TATGAAATTGGTAAACATTTTAGAAATGAAGGTATAGATAATACACATAATCCTGAATTTACTTCGTGTGAATTTTATTGGGCATATGCT	485
KRS1CAC	TATGAAATTGGTAAACACTTTAGAAATGAAGGTATAGATAATACACATAATCCTGAATTTACTTCGTGTGAATTTTATTGGGCATATGCT	8774
KRS1CAA	TATGAAATTGGTAAACAATTTAGAAATGAAGGTATAGATAATACACATAATCCTGAATTTACTTCGTGTGAATTTTATTGGGCATATGCT	4
KRS1CAG	TATGAAATTGGTAAACAGTTTAGAAATGAAGGTATAGATAATACACATAATCCTGAATTTACTTCGTGTGAATTTTATTGGGCATATGCT	27
KRS1AAT	TATGAAATTGGTAAAAATTTTAGAAATGAAGGTATAGATAATACACATAATCCTGAATTTACTTCGTGTGAATTTTATTGGGCATATGCT	2018
KRS1AAC	TATGAAATTGGTAAAAACTTTAGAAATGAAGGTATAGATAATACACATAATCCTGAATTTACTTCGTGTGAATTTTATTGGGCATATGCT	34
KRS1AAA	TATGAAATTGGTAAAAAATTTAGAAATGAAGGTATAGATAATACACATAATCCTGAATTTACTTCGTGTGAATTTTATTGGGCATATGCT	1
KRS1AAG	TATGAAATTGGTAAAAAGTTTAGAAATGAAGGTATAGATAATACACATAATCCTGAATTTACTTCGTGTGAATTTTATTGGGCATATGCT	0
KRS1GAT	TATGAAATTGGTAAAGATTTTAGAAATGAAGGTATAGATAATACACATAATCCTGAATTTACTTCGTGTGAATTTTATTGGGCATATGCT	34
KRS1GAC	TATGAAATTGGTAAAGACTTTAGAAATGAAGGTATAGATAATACACATAATCCTGAATTTACTTCGTGTGAATTTTATTGGGCATATGCT	278
KRS1GAA	TATGAAATTGGTAAAGAATTTAGAAATGAAGGTATAGATAATACACATAATCCTGAATTTACTTCGTGTGAATTTTATTGGGCATATGCT	20
KRS1GAG	TATGAAATTGGTAAAGAGTTTAGAAATGAAGGTATAGATAATACACATAATCCTGAATTTACTTCGTGTGAATTTTATTGGGCATATGCT	1
KRS1TGT	TATGAAATTGGTAAATGTTTTAGAAATGAAGGTATAGATAATACACATAATCCTGAATTTACTTCGTGTGAATTTTATTGGGCATATGCT	2127
KRS1TGC	TATGAAATTGGTAAATGCTTTAGAAATGAAGGTATAGATAATACACATAATCCTGAATTTACTTCGTGTGAATTTTATTGGGCATATGCT	146
KRS1TGA	TATGAAATTGGTAAATGATTTAGAAATGAAGGTATAGATAATACACATAATCCTGAATTTACTTCGTGTGAATTTTATTGGGCATATGCT	260
KRS1TGG	TATGAAATTGGTAAATGGTTTAGAAATGAAGGTATAGATAATACACATAATCCTGAATTTACTTCGTGTGAATTTTATTGGGCATATGCT	488
KRS1CGT	TATGAAATTGGTAAACGTTTTAGAAATGAAGGTATAGATAATACACATAATCCTGAATTTACTTCGTGTGAATTTTATTGGGCATATGCT	31
KRS1CGC	TATGAAATTGGTAAACGCTTTAGAAATGAAGGTATAGATAATACACATAATCCTGAATTTACTTCGTGTGAATTTTATTGGGCATATGCT	15
KRS1CGA	TATGAAATTGGTAAACGATTTAGAAATGAAGGTATAGATAATACACATAATCCTGAATTTACTTCGTGTGAATTTTATTGGGCATATGCT	2
KRS1CGG	TATGAAATTGGTAAACGGTTTAGAAATGAAGGTATAGATAATACACATAATCCTGAATTTACTTCGTGTGAATTTTATTGGGCATATGCT	3
KRS1AGT	TATGAAATTGGTAAAAGTTTTAGAAATGAAGGTATAGATAATACACATAATCCTGAATTTACTTCGTGTGAATTTTATTGGGCATATGCT	28
KRS1AGC	TATGAAATTGGTAAAAGCTTTAGAAATGAAGGTATAGATAATACACATAATCCTGAATTTACTTCGTGTGAATTTTATTGGGCATATGCT	2
KRS1AGA	TATGAAATTGGTAAAAGATTTAGAAATGAAGGTATAGATAATACACATAATCCTGAATTTACTTCGTGTGAATTTTATTGGGCATATGCT	1
KRS1AGG	TATGAAATTGGTAAAAGGTTTAGAAATGAAGGTATAGATAATACACATAATCCTGAATTTACTTCGTGTGAATTTTATTGGGCATATGCT	5
KRS1GGT	TATGAAATTGGTAAAGGTTTTAGAAATGAAGGTATAGATAATACACATAATCCTGAATTTACTTCGTGTGAATTTTATTGGGCATATGCT	39626
KRS1GGC	TATGAAATTGGTAAAGGCTTTAGAAATGAAGGTATAGATAATACACATAATCCTGAATTTACTTCGTGTGAATTTTATTGGGCATATGCT	98
KRS1GGA	TATGAAATTGGTAAAGGATTTAGAAATGAAGGTATAGATAATACACATAATCCTGAATTTACTTCGTGTGAATTTTATTGGGCATATGCT	684
KRS1GGG	TATGAAATTGGTAAAGGGTTTAGAAATGAAGGTATAGATAATACACATAATCCTGAATTTACTTCGTGTGAATTTTATTGGGCATATGCT	37
KRS2TTT	TATGAAATTGGTAAAGTATTTAGAAATGAAGGTATAGATAATACACATAATCCTGAATTTACTTCGTGTGAATTTTATTGGGCATATGCT	40702
KRS2TTC	TATGAAATTGGTAAAGTATTCAGAAATGAAGGTATAGATAATACACATAATCCTGAATTTACTTCGTGTGAATTTTATTGGGCATATGCT	44
KRS2TTA	TATGAAATTGGTAAAGTATTAAGAAATGAAGGTATAGATAATACACATAATCCTGAATTTACTTCGTGTGAATTTTATTGGGCATATGCT	28
KRS2TTG	TATGAAATTGGTAAAGTATTGAGAAATGAAGGTATAGATAATACACATAATCCTGAATTTACTTCGTGTGAATTTTATTGGGCATATGCT	12
KRS2CTT	TATGAAATTGGTAAAGTACTTAGAAATGAAGGTATAGATAATACACATAATCCTGAATTTACTTCGTGTGAATTTTATTGGGCATATGCT	120
KRS2CTC	TATGAAATTGGTAAAGTACTCAGAAATGAAGGTATAGATAATACACATAATCCTGAATTTACTTCGTGTGAATTTTATTGGGCATATGCT	30
KRS2CTA	TATGAAATTGGTAAAGTACTAAGAAATGAAGGTATAGATAATACACATAATCCTGAATTTACTTCGTGTGAATTTTATTGGGCATATGCT	0
KRS2CTG	TATGAAATTGGTAAAGTACTGAGAAATGAAGGTATAGATAATACACATAATCCTGAATTTACTTCGTGTGAATTTTATTGGGCATATGCT	3
KRS2ATT	TATGAAATTGGTAAAGTAATTAGAAATGAAGGTATAGATAATACACATAATCCTGAATTTACTTCGTGTGAATTTTATTGGGCATATGCT	43
KRS2ATC	TATGAAATTGGTAAAGTAATCAGAAATGAAGGTATAGATAATACACATAATCCTGAATTTACTTCGTGTGAATTTTATTGGGCATATGCT	1
KRS2ATA	TATGAAATTGGTAAAGTAATAAGAAATGAAGGTATAGATAATACACATAATCCTGAATTTACTTCGTGTGAATTTTATTGGGCATATGCT	7
KRS2ATG	TATGAAATTGGTAAAGTAATGAGAAATGAAGGTATAGATAATACACATAATCCTGAATTTACTTCGTGTGAATTTTATTGGGCATATGCT	1
KRS2GTT	TATGAAATTGGTAAAGTAGTTAGAAATGAAGGTATAGATAATACACATAATCCTGAATTTACTTCGTGTGAATTTTATTGGGCATATGCT	66
KRS2GTC	TATGAAATTGGTAAAGTAGTCAGAAATGAAGGTATAGATAATACACATAATCCTGAATTTACTTCGTGTGAATTTTATTGGGCATATGCT	1
KRS2GTA	TATGAAATTGGTAAAGTAGTAAGAAATGAAGGTATAGATAATACACATAATCCTGAATTTACTTCGTGTGAATTTTATTGGGCATATGCT	195
KRS2GTG	TATGAAATTGGTAAAGTAGTGAGAAATGAAGGTATAGATAATACACATAATCCTGAATTTACTTCGTGTGAATTTTATTGGGCATATGCT	0
KRS2TCT	TATGAAATTGGTAAAGTATCTAGAAATGAAGGTATAGATAATACACATAATCCTGAATTTACTTCGTGTGAATTTTATTGGGCATATGCT	94
KRS2TCC	TATGAAATTGGTAAAGTATCCAGAAATGAAGGTATAGATAATACACATAATCCTGAATTTACTTCGTGTGAATTTTATTGGGCATATGCT	26
KRS2TCA	TATGAAATTGGTAAAGTATCAAGAAATGAAGGTATAGATAATACACATAATCCTGAATTTACTTCGTGTGAATTTTATTGGGCATATGCT	96
KRS2TCG	TATGAAATTGGTAAAGTATCGAGAAATGAAGGTATAGATAATACACATAATCCTGAATTTACTTCGTGTGAATTTTATTGGGCATATGCT	0
KRS2CCT	TATGAAATTGGTAAAGTACCTAGAAATGAAGGTATAGATAATACACATAATCCTGAATTTACTTCGTGTGAATTTTATTGGGCATATGCT	2
KRS2CCC	TATGAAATTGGTAAAGTACCCAGAAATGAAGGTATAGATAATACACATAATCCTGAATTTACTTCGTGTGAATTTTATTGGGCATATGCT	8812
KRS2CCA	TATGAAATTGGTAAAGTACCAAGAAATGAAGGTATAGATAATACACATAATCCTGAATTTACTTCGTGTGAATTTTATTGGGCATATGCT	7
KRS2CCG	TATGAAATTGGTAAAGTACCGAGAAATGAAGGTATAGATAATACACATAATCCTGAATTTACTTCGTGTGAATTTTATTGGGCATATGCT	584
KRS2ACT	TATGAAATTGGTAAAGTAACTAGAAATGAAGGTATAGATAATACACATAATCCTGAATTTACTTCGTGTGAATTTTATTGGGCATATGCT	0
KRS2ACC	TATGAAATTGGTAAAGTAACCAGAAATGAAGGTATAGATAATACACATAATCCTGAATTTACTTCGTGTGAATTTTATTGGGCATATGCT	6
KRS2ACA	TATGAAATTGGTAAAGTAACAAGAAATGAAGGTATAGATAATACACATAATCCTGAATTTACTTCGTGTGAATTTTATTGGGCATATGCT	65
KRS2ACG	TATGAAATTGGTAAAGTAACGAGAAATGAAGGTATAGATAATACACATAATCCTGAATTTACTTCGTGTGAATTTTATTGGGCATATGCT	1
KRS2GCT	TATGAAATTGGTAAAGTAGCTAGAAATGAAGGTATAGATAATACACATAATCCTGAATTTACTTCGTGTGAATTTTATTGGGCATATGCT	4
KRS2GCC	TATGAAATTGGTAAAGTAGCCAGAAATGAAGGTATAGATAATACACATAATCCTGAATTTACTTCGTGTGAATTTTATTGGGCATATGCT	21
KRS2GCA	TATGAAATTGGTAAAGTAGCAAGAAATGAAGGTATAGATAATACACATAATCCTGAATTTACTTCGTGTGAATTTTATTGGGCATATGCT	0
KRS2GCG	TATGAAATTGGTAAAGTAGCGAGAAATGAAGGTATAGATAATACACATAATCCTGAATTTACTTCGTGTGAATTTTATTGGGCATATGCT	6
KRS2TAT	TATGAAATTGGTAAAGTATATAGAAATGAAGGTATAGATAATACACATAATCCTGAATTTACTTCGTGTGAATTTTATTGGGCATATGCT	53
KRS2TAC	TATGAAATTGGTAAAGTATACAGAAATGAAGGTATAGATAATACACATAATCCTGAATTTACTTCGTGTGAATTTTATTGGGCATATGCT	1
KRS2TAA	TATGAAATTGGTAAAGTATAAAGAAATGAAGGTATAGATAATACACATAATCCTGAATTTACTTCGTGTGAATTTTATTGGGCATATGCT	9157
KRS2TAG	TATGAAATTGGTAAAGTATAGAGAAATGAAGGTATAGATAATACACATAATCCTGAATTTACTTCGTGTGAATTTTATTGGGCATATGCT	16
KRS2CAT	TATGAAATTGGTAAAGTACATAGAAATGAAGGTATAGATAATACACATAATCCTGAATTTACTTCGTGTGAATTTTATTGGGCATATGCT	93
KRS2CAC	TATGAAATTGGTAAAGTACACAGAAATGAAGGTATAGATAATACACATAATCCTGAATTTACTTCGTGTGAATTTTATTGGGCATATGCT	32
KRS2CAA	TATGAAATTGGTAAAGTACAAAGAAATGAAGGTATAGATAATACACATAATCCTGAATTTACTTCGTGTGAATTTTATTGGGCATATGCT	23
KRS2CAG	TATGAAATTGGTAAAGTACAGAGAAATGAAGGTATAGATAATACACATAATCCTGAATTTACTTCGTGTGAATTTTATTGGGCATATGCT	4
KRS2AAT	TATGAAATTGGTAAAGTAAATAGAAATGAAGGTATAGATAATACACATAATCCTGAATTTACTTCGTGTGAATTTTATTGGGCATATGCT	0
KRS2AAC	TATGAAATTGGTAAAGTAAACAGAAATGAAGGTATAGATAATACACATAATCCTGAATTTACTTCGTGTGAATTTTATTGGGCATATGCT	1
KRS2AAA	TATGAAATTGGTAAAGTAAAAAGAAATGAAGGTATAGATAATACACATAATCCTGAATTTACTTCGTGTGAATTTTATTGGGCATATGCT	202
KRS2AAG	TATGAAATTGGTAAAGTAAAGAGAAATGAAGGTATAGATAATACACATAATCCTGAATTTACTTCGTGTGAATTTTATTGGGCATATGCT	1
KRS2GAT	TATGAAATTGGTAAAGTAGATAGAAATGAAGGTATAGATAATACACATAATCCTGAATTTACTTCGTGTGAATTTTATTGGGCATATGCT	0
KRS2GAC	TATGAAATTGGTAAAGTAGACAGAAATGAAGGTATAGATAATACACATAATCCTGAATTTACTTCGTGTGAATTTTATTGGGCATATGCT	0
KRS2GAA	TATGAAATTGGTAAAGTAGAAAGAAATGAAGGTATAGATAATACACATAATCCTGAATTTACTTCGTGTGAATTTTATTGGGCATATGCT	8
KRS2GAG	TATGAAATTGGTAAAGTAGAGAGAAATGAAGGTATAGATAATACACATAATCCTGAATTTACTTCGTGTGAATTTTATTGGGCATATGCT	0
KRS2TGT	TATGAAATTGGTAAAGTATGTAGAAATGAAGGTATAGATAATACACATAATCCTGAATTTACTTCGTGTGAATTTTATTGGGCATATGCT	19
KRS2TGC	TATGAAATTGGTAAAGTATGCAGAAATGAAGGTATAGATAATACACATAATCCTGAATTTACTTCGTGTGAATTTTATTGGGCATATGCT	1
KRS2TGA	TATGAAATTGGTAAAGTATGAAGAAATGAAGGTATAGATAATACACATAATCCTGAATTTACTTCGTGTGAATTTTATTGGGCATATGCT	12
KRS2TGG	TATGAAATTGGTAAAGTATGGAGAAATGAAGGTATAGATAATACACATAATCCTGAATTTACTTCGTGTGAATTTTATTGGGCATATGCT	0
KRS2CGT	TATGAAATTGGTAAAGTACGTAGAAATGAAGGTATAGATAATACACATAATCCTGAATTTACTTCGTGTGAATTTTATTGGGCATATGCT	0
KRS2CGC	TATGAAATTGGTAAAGTACGCAGAAATGAAGGTATAGATAATACACATAATCCTGAATTTACTTCGTGTGAATTTTATTGGGCATATGCT	24
KRS2CGA	TATGAAATTGGTAAAGTACGAAGAAATGAAGGTATAGATAATACACATAATCCTGAATTTACTTCGTGTGAATTTTATTGGGCATATGCT	3
KRS2CGG	TATGAAATTGGTAAAGTACGGAGAAATGAAGGTATAGATAATACACATAATCCTGAATTTACTTCGTGTGAATTTTATTGGGCATATGCT	1
KRS2AGT	TATGAAATTGGTAAAGTAAGTAGAAATGAAGGTATAGATAATACACATAATCCTGAATTTACTTCGTGTGAATTTTATTGGGCATATGCT	1
KRS2AGC	TATGAAATTGGTAAAGTAAGCAGAAATGAAGGTATAGATAATACACATAATCCTGAATTTACTTCGTGTGAATTTTATTGGGCATATGCT	0
KRS2AGA	TATGAAATTGGTAAAGTAAGAAGAAATGAAGGTATAGATAATACACATAATCCTGAATTTACTTCGTGTGAATTTTATTGGGCATATGCT	1
KRS2AGG	TATGAAATTGGTAAAGTAAGGAGAAATGAAGGTATAGATAATACACATAATCCTGAATTTACTTCGTGTGAATTTTATTGGGCATATGCT	0
KRS2GGT	TATGAAATTGGTAAAGTAGGTAGAAATGAAGGTATAGATAATACACATAATCCTGAATTTACTTCGTGTGAATTTTATTGGGCATATGCT	2
KRS2GGC	TATGAAATTGGTAAAGTAGGCAGAAATGAAGGTATAGATAATACACATAATCCTGAATTTACTTCGTGTGAATTTTATTGGGCATATGCT	3
KRS2GGA	TATGAAATTGGTAAAGTAGGAAGAAATGAAGGTATAGATAATACACATAATCCTGAATTTACTTCGTGTGAATTTTATTGGGCATATGCT	0
KRS2GGG	TATGAAATTGGTAAAGTAGGGAGAAATGAAGGTATAGATAATACACATAATCCTGAATTTACTTCGTGTGAATTTTATTGGGCATATGCT	4
KRS3TTT	TATGAAATTGGTAAAGTATTTTTTAATGAAGGTATAGATAATACACATAATCCTGAATTTACTTCGTGTGAATTTTATTGGGCATATGCT	5
KRS3TTC	TATGAAATTGGTAAAGTATTTTTCAATGAAGGTATAGATAATACACATAATCCTGAATTTACTTCGTGTGAATTTTATTGGGCATATGCT	0
KRS3TTA	TATGAAATTGGTAAAGTATTTTTAAATGAAGGTATAGATAATACACATAATCCTGAATTTACTTCGTGTGAATTTTATTGGGCATATGCT	2
KRS3TTG	TATGAAATTGGTAAAGTATTTTTGAATGAAGGTATAGATAATACACATAATCCTGAATTTACTTCGTGTGAATTTTATTGGGCATATGCT	1
KRS3CTT	TATGAAATTGGTAAAGTATTTCTTAATGAAGGTATAGATAATACACATAATCCTGAATTTACTTCGTGTGAATTTTATTGGGCATATGCT	0
KRS3CTC	TATGAAATTGGTAAAGTATTTCTCAATGAAGGTATAGATAATACACATAATCCTGAATTTACTTCGTGTGAATTTTATTGGGCATATGCT	0
KRS3CTA	TATGAAATTGGTAAAGTATTTCTAAATGAAGGTATAGATAATACACATAATCCTGAATTTACTTCGTGTGAATTTTATTGGGCATATGCT	0
KRS3CTG	TATGAAATTGGTAAAGTATTTCTGAATGAAGGTATAGATAATACACATAATCCTGAATTTACTTCGTGTGAATTTTATTGGGCATATGCT	0
KRS3ATT	TATGAAATTGGTAAAGTATTTATTAATGAAGGTATAGATAATACACATAATCCTGAATTTACTTCGTGTGAATTTTATTGGGCATATGCT	1
KRS3ATC	TATGAAATTGGTAAAGTATTTATCAATGAAGGTATAGATAATACACATAATCCTGAATTTACTTCGTGTGAATTTTATTGGGCATATGCT	0
KRS3ATA	TATGAAATTGGTAAAGTATTTATAAATGAAGGTATAGATAATACACATAATCCTGAATTTACTTCGTGTGAATTTTATTGGGCATATGCT	4
KRS3ATG	TATGAAATTGGTAAAGTATTTATGAATGAAGGTATAGATAATACACATAATCCTGAATTTACTTCGTGTGAATTTTATTGGGCATATGCT	1
KRS3GTT	TATGAAATTGGTAAAGTATTTGTTAATGAAGGTATAGATAATACACATAATCCTGAATTTACTTCGTGTGAATTTTATTGGGCATATGCT	1
KRS3GTC	TATGAAATTGGTAAAGTATTTGTCAATGAAGGTATAGATAATACACATAATCCTGAATTTACTTCGTGTGAATTTTATTGGGCATATGCT	0
KRS3GTA	TATGAAATTGGTAAAGTATTTGTAAATGAAGGTATAGATAATACACATAATCCTGAATTTACTTCGTGTGAATTTTATTGGGCATATGCT	1
KRS3GTG	TATGAAATTGGTAAAGTATTTGTGAATGAAGGTATAGATAATACACATAATCCTGAATTTACTTCGTGTGAATTTTATTGGGCATATGCT	0
KRS3TCT	TATGAAATTGGTAAAGTATTTTCTAATGAAGGTATAGATAATACACATAATCCTGAATTTACTTCGTGTGAATTTTATTGGGCATATGCT	2
KRS3TCC	TATGAAATTGGTAAAGTATTTTCCAATGAAGGTATAGATAATACACATAATCCTGAATTTACTTCGTGTGAATTTTATTGGGCATATGCT	1
KRS3TCA	TATGAAATTGGTAAAGTATTTTCAAATGAAGGTATAGATAATACACATAATCCTGAATTTACTTCGTGTGAATTTTATTGGGCATATGCT	1
KRS3TCG	TATGAAATTGGTAAAGTATTTTCGAATGAAGGTATAGATAATACACATAATCCTGAATTTACTTCGTGTGAATTTTATTGGGCATATGCT	0
KRS3CCT	TATGAAATTGGTAAAGTATTTCCTAATGAAGGTATAGATAATACACATAATCCTGAATTTACTTCGTGTGAATTTTATTGGGCATATGCT	0
KRS3CCC	TATGAAATTGGTAAAGTATTTCCCAATGAAGGTATAGATAATACACATAATCCTGAATTTACTTCGTGTGAATTTTATTGGGCATATGCT	1
KRS3CCA	TATGAAATTGGTAAAGTATTTCCAAATGAAGGTATAGATAATACACATAATCCTGAATTTACTTCGTGTGAATTTTATTGGGCATATGCT	1
KRS3CCG	TATGAAATTGGTAAAGTATTTCCGAATGAAGGTATAGATAATACACATAATCCTGAATTTACTTCGTGTGAATTTTATTGGGCATATGCT	1
KRS3ACT	TATGAAATTGGTAAAGTATTTACTAATGAAGGTATAGATAATACACATAATCCTGAATTTACTTCGTGTGAATTTTATTGGGCATATGCT	0
KRS3ACC	TATGAAATTGGTAAAGTATTTACCAATGAAGGTATAGATAATACACATAATCCTGAATTTACTTCGTGTGAATTTTATTGGGCATATGCT	0
KRS3ACA	TATGAAATTGGTAAAGTATTTACAAATGAAGGTATAGATAATACACATAATCCTGAATTTACTTCGTGTGAATTTTATTGGGCATATGCT	28
KRS3ACG	TATGAAATTGGTAAAGTATTTACGAATGAAGGTATAGATAATACACATAATCCTGAATTTACTTCGTGTGAATTTTATTGGGCATATGCT	1
KRS3GCT	TATGAAATTGGTAAAGTATTTGCTAATGAAGGTATAGATAATACACATAATCCTGAATTTACTTCGTGTGAATTTTATTGGGCATATGCT	1
KRS3GCC	TATGAAATTGGTAAAGTATTTGCCAATGAAGGTATAGATAATACACATAATCCTGAATTTACTTCGTGTGAATTTTATTGGGCATATGCT	0
KRS3GCA	TATGAAATTGGTAAAGTATTTGCAAATGAAGGTATAGATAATACACATAATCCTGAATTTACTTCGTGTGAATTTTATTGGGCATATGCT	0
KRS3GCG	TATGAAATTGGTAAAGTATTTGCGAATGAAGGTATAGATAATACACATAATCCTGAATTTACTTCGTGTGAATTTTATTGGGCATATGCT	0
KRS3TAT	TATGAAATTGGTAAAGTATTTTATAATGAAGGTATAGATAATACACATAATCCTGAATTTACTTCGTGTGAATTTTATTGGGCATATGCT	3
KRS3TAC	TATGAAATTGGTAAAGTATTTTACAATGAAGGTATAGATAATACACATAATCCTGAATTTACTTCGTGTGAATTTTATTGGGCATATGCT	0
KRS3TAA	TATGAAATTGGTAAAGTATTTTAAAATGAAGGTATAGATAATACACATAATCCTGAATTTACTTCGTGTGAATTTTATTGGGCATATGCT	2
KRS3TAG	TATGAAATTGGTAAAGTATTTTAGAATGAAGGTATAGATAATACACATAATCCTGAATTTACTTCGTGTGAATTTTATTGGGCATATGCT	0
KRS3CAT	TATGAAATTGGTAAAGTATTTCATAATGAAGGTATAGATAATACACATAATCCTGAATTTACTTCGTGTGAATTTTATTGGGCATATGCT	0
KRS3CAC	TATGAAATTGGTAAAGTATTTCACAATGAAGGTATAGATAATACACATAATCCTGAATTTACTTCGTGTGAATTTTATTGGGCATATGCT	1
KRS3CAA	TATGAAATTGGTAAAGTATTTCAAAATGAAGGTATAGATAATACACATAATCCTGAATTTACTTCGTGTGAATTTTATTGGGCATATGCT	1
KRS3CAG	TATGAAATTGGTAAAGTATTTCAGAATGAAGGTATAGATAATACACATAATCCTGAATTTACTTCGTGTGAATTTTATTGGGCATATGCT	0
KRS3AAT	TATGAAATTGGTAAAGTATTTAATAATGAAGGTATAGATAATACACATAATCCTGAATTTACTTCGTGTGAATTTTATTGGGCATATGCT	0
KRS3AAC	TATGAAATTGGTAAAGTATTTAACAATGAAGGTATAGATAATACACATAATCCTGAATTTACTTCGTGTGAATTTTATTGGGCATATGCT	0
KRS3AAA	TATGAAATTGGTAAAGTATTTAAAAATGAAGGTATAGATAATACACATAATCCTGAATTTACTTCGTGTGAATTTTATTGGGCATATGCT	18
KRS3AAG	TATGAAATTGGTAAAGTATTTAAGAATGAAGGTATAGATAATACACATAATCCTGAATTTACTTCGTGTGAATTTTATTGGGCATATGCT	0
KRS3GAT	TATGAAATTGGTAAAGTATTTGATAATGAAGGTATAGATAATACACATAATCCTGAATTTACTTCGTGTGAATTTTATTGGGCATATGCT	0
KRS3GAC	TATGAAATTGGTAAAGTATTTGACAATGAAGGTATAGATAATACACATAATCCTGAATTTACTTCGTGTGAATTTTATTGGGCATATGCT	1
KRS3GAA	TATGAAATTGGTAAAGTATTTGAAAATGAAGGTATAGATAATACACATAATCCTGAATTTACTTCGTGTGAATTTTATTGGGCATATGCT	0
KRS3GAG	TATGAAATTGGTAAAGTATTTGAGAATGAAGGTATAGATAATACACATAATCCTGAATTTACTTCGTGTGAATTTTATTGGGCATATGCT	2
KRS3TGT	TATGAAATTGGTAAAGTATTTTGTAATGAAGGTATAGATAATACACATAATCCTGAATTTACTTCGTGTGAATTTTATTGGGCATATGCT	1
KRS3TGC	TATGAAATTGGTAAAGTATTTTGCAATGAAGGTATAGATAATACACATAATCCTGAATTTACTTCGTGTGAATTTTATTGGGCATATGCT	1
KRS3TGA	TATGAAATTGGTAAAGTATTTTGAAATGAAGGTATAGATAATACACATAATCCTGAATTTACTTCGTGTGAATTTTATTGGGCATATGCT	10
KRS3TGG	TATGAAATTGGTAAAGTATTTTGGAATGAAGGTATAGATAATACACATAATCCTGAATTTACTTCGTGTGAATTTTATTGGGCATATGCT	1
KRS3CGT	TATGAAATTGGTAAAGTATTTCGTAATGAAGGTATAGATAATACACATAATCCTGAATTTACTTCGTGTGAATTTTATTGGGCATATGCT	1
KRS3CGC	TATGAAATTGGTAAAGTATTTCGCAATGAAGGTATAGATAATACACATAATCCTGAATTTACTTCGTGTGAATTTTATTGGGCATATGCT	1
KRS3CGA	TATGAAATTGGTAAAGTATTTCGAAATGAAGGTATAGATAATACACATAATCCTGAATTTACTTCGTGTGAATTTTATTGGGCATATGCT	10
KRS3CGG	TATGAAATTGGTAAAGTATTTCGGAATGAAGGTATAGATAATACACATAATCCTGAATTTACTTCGTGTGAATTTTATTGGGCATATGCT	0
KRS3AGT	TATGAAATTGGTAAAGTATTTAGTAATGAAGGTATAGATAATACACATAATCCTGAATTTACTTCGTGTGAATTTTATTGGGCATATGCT	33
KRS3AGC	TATGAAATTGGTAAAGTATTTAGCAATGAAGGTATAGATAATACACATAATCCTGAATTTACTTCGTGTGAATTTTATTGGGCATATGCT	2
KRS3AGA	TATGAAATTGGTAAAGTATTTAGAAATGAAGGTATAGATAATACACATAATCCTGAATTTACTTCGTGTGAATTTTATTGGGCATATGCT	40702
KRS3AGG	TATGAAATTGGTAAAGTATTTAGGAATGAAGGTATAGATAATACACATAATCCTGAATTTACTTCGTGTGAATTTTATTGGGCATATGCT	85
KRS3GGT	TATGAAATTGGTAAAGTATTTGGTAATGAAGGTATAGATAATACACATAATCCTGAATTTACTTCGTGTGAATTTTATTGGGCATATGCT	0
KRS3GGC	TATGAAATTGGTAAAGTATTTGGCAATGAAGGTATAGATAATACACATAATCCTGAATTTACTTCGTGTGAATTTTATTGGGCATATGCT	0
KRS3GGA	TATGAAATTGGTAAAGTATTTGGAAATGAAGGTATAGATAATACACATAATCCTGAATTTACTTCGTGTGAATTTTATTGGGCATATGCT	47
KRS3GGG	TATGAAATTGGTAAAGTATTTGGGAATGAAGGTATAGATAATACACATAATCCTGAATTTACTTCGTGTGAATTTTATTGGGCATATGCT	0
KRS4TTT	TATGAAATTGGTAAAGTATTTAGATTTGAAGGTATAGATAATACACATAATCCTGAATTTACTTCGTGTGAATTTTATTGGGCATATGCT	5
KRS4TTC	TATGAAATTGGTAAAGTATTTAGATTCGAAGGTATAGATAATACACATAATCCTGAATTTACTTCGTGTGAATTTTATTGGGCATATGCT	1
KRS4TTA	TATGAAATTGGTAAAGTATTTAGATTAGAAGGTATAGATAATACACATAATCCTGAATTTACTTCGTGTGAATTTTATTGGGCATATGCT	0
KRS4TTG	TATGAAATTGGTAAAGTATTTAGATTGGAAGGTATAGATAATACACATAATCCTGAATTTACTTCGTGTGAATTTTATTGGGCATATGCT	1
KRS4CTT	TATGAAATTGGTAAAGTATTTAGACTTGAAGGTATAGATAATACACATAATCCTGAATTTACTTCGTGTGAATTTTATTGGGCATATGCT	1
KRS4CTC	TATGAAATTGGTAAAGTATTTAGACTCGAAGGTATAGATAATACACATAATCCTGAATTTACTTCGTGTGAATTTTATTGGGCATATGCT	0
KRS4CTA	TATGAAATTGGTAAAGTATTTAGACTAGAAGGTATAGATAATACACATAATCCTGAATTTACTTCGTGTGAATTTTATTGGGCATATGCT	1
KRS4CTG	TATGAAATTGGTAAAGTATTTAGACTGGAAGGTATAGATAATACACATAATCCTGAATTTACTTCGTGTGAATTTTATTGGGCATATGCT	1
KRS4ATT	TATGAAATTGGTAAAGTATTTAGAATTGAAGGTATAGATAATACACATAATCCTGAATTTACTTCGTGTGAATTTTATTGGGCATATGCT	17
KRS4ATC	TATGAAATTGGTAAAGTATTTAGAATCGAAGGTATAGATAATACACATAATCCTGAATTTACTTCGTGTGAATTTTATTGGGCATATGCT	1
KRS4ATA	TATGAAATTGGTAAAGTATTTAGAATAGAAGGTATAGATAATACACATAATCCTGAATTTACTTCGTGTGAATTTTATTGGGCATATGCT	1
KRS4ATG	TATGAAATTGGTAAAGTATTTAGAATGGAAGGTATAGATAATACACATAATCCTGAATTTACTTCGTGTGAATTTTATTGGGCATATGCT	0
KRS4GTT	TATGAAATTGGTAAAGTATTTAGAGTTGAAGGTATAGATAATACACATAATCCTGAATTTACTTCGTGTGAATTTTATTGGGCATATGCT	2
KRS4GTC	TATGAAATTGGTAAAGTATTTAGAGTCGAAGGTATAGATAATACACATAATCCTGAATTTACTTCGTGTGAATTTTATTGGGCATATGCT	0
KRS4GTA	TATGAAATTGGTAAAGTATTTAGAGTAGAAGGTATAGATAATACACATAATCCTGAATTTACTTCGTGTGAATTTTATTGGGCATATGCT	0
KRS4GTG	TATGAAATTGGTAAAGTATTTAGAGTGGAAGGTATAGATAATACACATAATCCTGAATTTACTTCGTGTGAATTTTATTGGGCATATGCT	1
KRS4TCT	TATGAAATTGGTAAAGTATTTAGATCTGAAGGTATAGATAATACACATAATCCTGAATTTACTTCGTGTGAATTTTATTGGGCATATGCT	1
KRS4TCC	TATGAAATTGGTAAAGTATTTAGATCCGAAGGTATAGATAATACACATAATCCTGAATTTACTTCGTGTGAATTTTATTGGGCATATGCT	0
KRS4TCA	TATGAAATTGGTAAAGTATTTAGATCAGAAGGTATAGATAATACACATAATCCTGAATTTACTTCGTGTGAATTTTATTGGGCATATGCT	1
KRS4TCG	TATGAAATTGGTAAAGTATTTAGATCGGAAGGTATAGATAATACACATAATCCTGAATTTACTTCGTGTGAATTTTATTGGGCATATGCT	0
KRS4CCT	TATGAAATTGGTAAAGTATTTAGACCTGAAGGTATAGATAATACACATAATCCTGAATTTACTTCGTGTGAATTTTATTGGGCATATGCT	2
KRS4CCC	TATGAAATTGGTAAAGTATTTAGACCCGAAGGTATAGATAATACACATAATCCTGAATTTACTTCGTGTGAATTTTATTGGGCATATGCT	0
KRS4CCA	TATGAAATTGGTAAAGTATTTAGACCAGAAGGTATAGATAATACACATAATCCTGAATTTACTTCGTGTGAATTTTATTGGGCATATGCT	0
KRS4CCG	TATGAAATTGGTAAAGTATTTAGACCGGAAGGTATAGATAATACACATAATCCTGAATTTACTTCGTGTGAATTTTATTGGGCATATGCT	1
KRS4ACT	TATGAAATTGGTAAAGTATTTAGAACTGAAGGTATAGATAATACACATAATCCTGAATTTACTTCGTGTGAATTTTATTGGGCATATGCT	9
KRS4ACC	TATGAAATTGGTAAAGTATTTAGAACCGAAGGTATAGATAATACACATAATCCTGAATTTACTTCGTGTGAATTTTATTGGGCATATGCT	0
KRS4ACA	TATGAAATTGGTAAAGTATTTAGAACAGAAGGTATAGATAATACACATAATCCTGAATTTACTTCGTGTGAATTTTATTGGGCATATGCT	1
KRS4ACG	TATGAAATTGGTAAAGTATTTAGAACGGAAGGTATAGATAATACACATAATCCTGAATTTACTTCGTGTGAATTTTATTGGGCATATGCT	0
KRS4GCT	TATGAAATTGGTAAAGTATTTAGAGCTGAAGGTATAGATAATACACATAATCCTGAATTTACTTCGTGTGAATTTTATTGGGCATATGCT	0
KRS4GCC	TATGAAATTGGTAAAGTATTTAGAGCCGAAGGTATAGATAATACACATAATCCTGAATTTACTTCGTGTGAATTTTATTGGGCATATGCT	0
KRS4GCA	TATGAAATTGGTAAAGTATTTAGAGCAGAAGGTATAGATAATACACATAATCCTGAATTTACTTCGTGTGAATTTTATTGGGCATATGCT	0
KRS4GCG	TATGAAATTGGTAAAGTATTTAGAGCGGAAGGTATAGATAATACACATAATCCTGAATTTACTTCGTGTGAATTTTATTGGGCATATGCT	0
KRS4TAT	TATGAAATTGGTAAAGTATTTAGATATGAAGGTATAGATAATACACATAATCCTGAATTTACTTCGTGTGAATTTTATTGGGCATATGCT	22
KRS4TAC	TATGAAATTGGTAAAGTATTTAGATACGAAGGTATAGATAATACACATAATCCTGAATTTACTTCGTGTGAATTTTATTGGGCATATGCT	1
KRS4TAA	TATGAAATTGGTAAAGTATTTAGATAAGAAGGTATAGATAATACACATAATCCTGAATTTACTTCGTGTGAATTTTATTGGGCATATGCT	2
KRS4TAG	TATGAAATTGGTAAAGTATTTAGATAGGAAGGTATAGATAATACACATAATCCTGAATTTACTTCGTGTGAATTTTATTGGGCATATGCT	2
KRS4CAT	TATGAAATTGGTAAAGTATTTAGACATGAAGGTATAGATAATACACATAATCCTGAATTTACTTCGTGTGAATTTTATTGGGCATATGCT	10
KRS4CAC	TATGAAATTGGTAAAGTATTTAGACACGAAGGTATAGATAATACACATAATCCTGAATTTACTTCGTGTGAATTTTATTGGGCATATGCT	1
KRS4CAA	TATGAAATTGGTAAAGTATTTAGACAAGAAGGTATAGATAATACACATAATCCTGAATTTACTTCGTGTGAATTTTATTGGGCATATGCT	2
KRS4CAG	TATGAAATTGGTAAAGTATTTAGACAGGAAGGTATAGATAATACACATAATCCTGAATTTACTTCGTGTGAATTTTATTGGGCATATGCT	2
KRS4AAT	TATGAAATTGGTAAAGTATTTAGAAATGAAGGTATAGATAATACACATAATCCTGAATTTACTTCGTGTGAATTTTATTGGGCATATGCT	40702
KRS4AAC	TATGAAATTGGTAAAGTATTTAGAAACGAAGGTATAGATAATACACATAATCCTGAATTTACTTCGTGTGAATTTTATTGGGCATATGCT	60
KRS4AAA	TATGAAATTGGTAAAGTATTTAGAAAAGAAGGTATAGATAATACACATAATCCTGAATTTACTTCGTGTGAATTTTATTGGGCATATGCT	22
KRS4AAG	TATGAAATTGGTAAAGTATTTAGAAAGGAAGGTATAGATAATACACATAATCCTGAATTTACTTCGTGTGAATTTTATTGGGCATATGCT	2
KRS4GAT	TATGAAATTGGTAAAGTATTTAGAGATGAAGGTATAGATAATACACATAATCCTGAATTTACTTCGTGTGAATTTTATTGGGCATATGCT	93
KRS4GAC	TATGAAATTGGTAAAGTATTTAGAGACGAAGGTATAGATAATACACATAATCCTGAATTTACTTCGTGTGAATTTTATTGGGCATATGCT	0
KRS4GAA	TATGAAATTGGTAAAGTATTTAGAGAAGAAGGTATAGATAATACACATAATCCTGAATTTACTTCGTGTGAATTTTATTGGGCATATGCT	1
KRS4GAG	TATGAAATTGGTAAAGTATTTAGAGAGGAAGGTATAGATAATACACATAATCCTGAATTTACTTCGTGTGAATTTTATTGGGCATATGCT	0
KRS4TGT	TATGAAATTGGTAAAGTATTTAGATGTGAAGGTATAGATAATACACATAATCCTGAATTTACTTCGTGTGAATTTTATTGGGCATATGCT	9
KRS4TGC	TATGAAATTGGTAAAGTATTTAGATGCGAAGGTATAGATAATACACATAATCCTGAATTTACTTCGTGTGAATTTTATTGGGCATATGCT	0
KRS4TGA	TATGAAATTGGTAAAGTATTTAGATGAGAAGGTATAGATAATACACATAATCCTGAATTTACTTCGTGTGAATTTTATTGGGCATATGCT	1
KRS4TGG	TATGAAATTGGTAAAGTATTTAGATGGGAAGGTATAGATAATACACATAATCCTGAATTTACTTCGTGTGAATTTTATTGGGCATATGCT	1
KRS4CGT	TATGAAATTGGTAAAGTATTTAGACGTGAAGGTATAGATAATACACATAATCCTGAATTTACTTCGTGTGAATTTTATTGGGCATATGCT	1
KRS4CGC	TATGAAATTGGTAAAGTATTTAGACGCGAAGGTATAGATAATACACATAATCCTGAATTTACTTCGTGTGAATTTTATTGGGCATATGCT	0
KRS4CGA	TATGAAATTGGTAAAGTATTTAGACGAGAAGGTATAGATAATACACATAATCCTGAATTTACTTCGTGTGAATTTTATTGGGCATATGCT	1
KRS4CGG	TATGAAATTGGTAAAGTATTTAGACGGGAAGGTATAGATAATACACATAATCCTGAATTTACTTCGTGTGAATTTTATTGGGCATATGCT	0
KRS4AGT	TATGAAATTGGTAAAGTATTTAGAAGTGAAGGTATAGATAATACACATAATCCTGAATTTACTTCGTGTGAATTTTATTGGGCATATGCT	102
KRS4AGC	TATGAAATTGGTAAAGTATTTAGAAGCGAAGGTATAGATAATACACATAATCCTGAATTTACTTCGTGTGAATTTTATTGGGCATATGCT	2
KRS4AGA	TATGAAATTGGTAAAGTATTTAGAAGAGAAGGTATAGATAATACACATAATCCTGAATTTACTTCGTGTGAATTTTATTGGGCATATGCT	0
KRS4AGG	TATGAAATTGGTAAAGTATTTAGAAGGGAAGGTATAGATAATACACATAATCCTGAATTTACTTCGTGTGAATTTTATTGGGCATATGCT	0
KRS4GGT	TATGAAATTGGTAAAGTATTTAGAGGTGAAGGTATAGATAATACACATAATCCTGAATTTACTTCGTGTGAATTTTATTGGGCATATGCT	1
KRS4GGC	TATGAAATTGGTAAAGTATTTAGAGGCGAAGGTATAGATAATACACATAATCCTGAATTTACTTCGTGTGAATTTTATTGGGCATATGCT	0
KRS4GGA	TATGAAATTGGTAAAGTATTTAGAGGAGAAGGTATAGATAATACACATAATCCTGAATTTACTTCGTGTGAATTTTATTGGGCATATGCT	0
KRS4GGG	TATGAAATTGGTAAAGTATTTAGAGGGGAAGGTATAGATAATACACATAATCCTGAATTTACTTCGTGTGAATTTTATTGGGCATATGCT	0
KRS5TTT	TATGAAATTGGTAAAGTATTTAGAAATTTTGGTATAGATAATACACATAATCCTGAATTTACTTCGTGTGAATTTTATTGGGCATATGCT	29
KRS5TTC	TATGAAATTGGTAAAGTATTTAGAAATTTCGGTATAGATAATACACATAATCCTGAATTTACTTCGTGTGAATTTTATTGGGCATATGCT	2
KRS5TTA	TATGAAATTGGTAAAGTATTTAGAAATTTAGGTATAGATAATACACATAATCCTGAATTTACTTCGTGTGAATTTTATTGGGCATATGCT	4
KRS5TTG	TATGAAATTGGTAAAGTATTTAGAAATTTGGGTATAGATAATACACATAATCCTGAATTTACTTCGTGTGAATTTTATTGGGCATATGCT	4
KRS5CTT	TATGAAATTGGTAAAGTATTTAGAAATCTTGGTATAGATAATACACATAATCCTGAATTTACTTCGTGTGAATTTTATTGGGCATATGCT	6
KRS5CTC	TATGAAATTGGTAAAGTATTTAGAAATCTCGGTATAGATAATACACATAATCCTGAATTTACTTCGTGTGAATTTTATTGGGCATATGCT	0
KRS5CTA	TATGAAATTGGTAAAGTATTTAGAAATCTAGGTATAGATAATACACATAATCCTGAATTTACTTCGTGTGAATTTTATTGGGCATATGCT	2
KRS5CTG	TATGAAATTGGTAAAGTATTTAGAAATCTGGGTATAGATAATACACATAATCCTGAATTTACTTCGTGTGAATTTTATTGGGCATATGCT	1
KRS5ATT	TATGAAATTGGTAAAGTATTTAGAAATATTGGTATAGATAATACACATAATCCTGAATTTACTTCGTGTGAATTTTATTGGGCATATGCT	16
KRS5ATC	TATGAAATTGGTAAAGTATTTAGAAATATCGGTATAGATAATACACATAATCCTGAATTTACTTCGTGTGAATTTTATTGGGCATATGCT	2
KRS5ATA	TATGAAATTGGTAAAGTATTTAGAAATATAGGTATAGATAATACACATAATCCTGAATTTACTTCGTGTGAATTTTATTGGGCATATGCT	3
KRS5ATG	TATGAAATTGGTAAAGTATTTAGAAATATGGGTATAGATAATACACATAATCCTGAATTTACTTCGTGTGAATTTTATTGGGCATATGCT	0
KRS5GTT	TATGAAATTGGTAAAGTATTTAGAAATGTTGGTATAGATAATACACATAATCCTGAATTTACTTCGTGTGAATTTTATTGGGCATATGCT	9
KRS5GTC	TATGAAATTGGTAAAGTATTTAGAAATGTCGGTATAGATAATACACATAATCCTGAATTTACTTCGTGTGAATTTTATTGGGCATATGCT	4
KRS5GTA	TATGAAATTGGTAAAGTATTTAGAAATGTAGGTATAGATAATACACATAATCCTGAATTTACTTCGTGTGAATTTTATTGGGCATATGCT	36
KRS5GTG	TATGAAATTGGTAAAGTATTTAGAAATGTGGGTATAGATAATACACATAATCCTGAATTTACTTCGTGTGAATTTTATTGGGCATATGCT	0
KRS5TCT	TATGAAATTGGTAAAGTATTTAGAAATTCTGGTATAGATAATACACATAATCCTGAATTTACTTCGTGTGAATTTTATTGGGCATATGCT	6
KRS5TCC	TATGAAATTGGTAAAGTATTTAGAAATTCCGGTATAGATAATACACATAATCCTGAATTTACTTCGTGTGAATTTTATTGGGCATATGCT	2
KRS5TCA	TATGAAATTGGTAAAGTATTTAGAAATTCAGGTATAGATAATACACATAATCCTGAATTTACTTCGTGTGAATTTTATTGGGCATATGCT	3
KRS5TCG	TATGAAATTGGTAAAGTATTTAGAAATTCGGGTATAGATAATACACATAATCCTGAATTTACTTCGTGTGAATTTTATTGGGCATATGCT	3
KRS5CCT	TATGAAATTGGTAAAGTATTTAGAAATCCTGGTATAGATAATACACATAATCCTGAATTTACTTCGTGTGAATTTTATTGGGCATATGCT	5
KRS5CCC	TATGAAATTGGTAAAGTATTTAGAAATCCCGGTATAGATAATACACATAATCCTGAATTTACTTCGTGTGAATTTTATTGGGCATATGCT	0
KRS5CCA	TATGAAATTGGTAAAGTATTTAGAAATCCAGGTATAGATAATACACATAATCCTGAATTTACTTCGTGTGAATTTTATTGGGCATATGCT	2
KRS5CCG	TATGAAATTGGTAAAGTATTTAGAAATCCGGGTATAGATAATACACATAATCCTGAATTTACTTCGTGTGAATTTTATTGGGCATATGCT	2
KRS5ACT	TATGAAATTGGTAAAGTATTTAGAAATACTGGTATAGATAATACACATAATCCTGAATTTACTTCGTGTGAATTTTATTGGGCATATGCT	0
KRS5ACC	TATGAAATTGGTAAAGTATTTAGAAATACCGGTATAGATAATACACATAATCCTGAATTTACTTCGTGTGAATTTTATTGGGCATATGCT	0
KRS5ACA	TATGAAATTGGTAAAGTATTTAGAAATACAGGTATAGATAATACACATAATCCTGAATTTACTTCGTGTGAATTTTATTGGGCATATGCT	4
KRS5ACG	TATGAAATTGGTAAAGTATTTAGAAATACGGGTATAGATAATACACATAATCCTGAATTTACTTCGTGTGAATTTTATTGGGCATATGCT	3
KRS5GCT	TATGAAATTGGTAAAGTATTTAGAAATGCTGGTATAGATAATACACATAATCCTGAATTTACTTCGTGTGAATTTTATTGGGCATATGCT	5
KRS5GCC	TATGAAATTGGTAAAGTATTTAGAAATGCCGGTATAGATAATACACATAATCCTGAATTTACTTCGTGTGAATTTTATTGGGCATATGCT	2
KRS5GCA	TATGAAATTGGTAAAGTATTTAGAAATGCAGGTATAGATAATACACATAATCCTGAATTTACTTCGTGTGAATTTTATTGGGCATATGCT	10
KRS5GCG	TATGAAATTGGTAAAGTATTTAGAAATGCGGGTATAGATAATACACATAATCCTGAATTTACTTCGTGTGAATTTTATTGGGCATATGCT	0
KRS5TAT	TATGAAATTGGTAAAGTATTTAGAAATTATGGTATAGATAATACACATAATCCTGAATTTACTTCGTGTGAATTTTATTGGGCATATGCT	8
KRS5TAC	TATGAAATTGGTAAAGTATTTAGAAATTACGGTATAGATAATACACATAATCCTGAATTTACTTCGTGTGAATTTTATTGGGCATATGCT	0
KRS5TAA	TATGAAATTGGTAAAGTATTTAGAAATTAAGGTATAGATAATACACATAATCCTGAATTTACTTCGTGTGAATTTTATTGGGCATATGCT	3
KRS5TAG	TATGAAATTGGTAAAGTATTTAGAAATTAGGGTATAGATAATACACATAATCCTGAATTTACTTCGTGTGAATTTTATTGGGCATATGCT	3
KRS5CAT	TATGAAATTGGTAAAGTATTTAGAAATCATGGTATAGATAATACACATAATCCTGAATTTACTTCGTGTGAATTTTATTGGGCATATGCT	2
KRS5CAC	TATGAAATTGGTAAAGTATTTAGAAATCACGGTATAGATAATACACATAATCCTGAATTTACTTCGTGTGAATTTTATTGGGCATATGCT	1
KRS5CAA	TATGAAATTGGTAAAGTATTTAGAAATCAAGGTATAGATAATACACATAATCCTGAATTTACTTCGTGTGAATTTTATTGGGCATATGCT	14
KRS5CAG	TATGAAATTGGTAAAGTATTTAGAAATCAGGGTATAGATAATACACATAATCCTGAATTTACTTCGTGTGAATTTTATTGGGCATATGCT	5
KRS5AAT	TATGAAATTGGTAAAGTATTTAGAAATAATGGTATAGATAATACACATAATCCTGAATTTACTTCGTGTGAATTTTATTGGGCATATGCT	3
KRS5AAC	TATGAAATTGGTAAAGTATTTAGAAATAACGGTATAGATAATACACATAATCCTGAATTTACTTCGTGTGAATTTTATTGGGCATATGCT	3
KRS5AAA	TATGAAATTGGTAAAGTATTTAGAAATAAAGGTATAGATAATACACATAATCCTGAATTTACTTCGTGTGAATTTTATTGGGCATATGCT	15
KRS5AAG	TATGAAATTGGTAAAGTATTTAGAAATAAGGGTATAGATAATACACATAATCCTGAATTTACTTCGTGTGAATTTTATTGGGCATATGCT	2
KRS5GAT	TATGAAATTGGTAAAGTATTTAGAAATGATGGTATAGATAATACACATAATCCTGAATTTACTTCGTGTGAATTTTATTGGGCATATGCT	24
KRS5GAC	TATGAAATTGGTAAAGTATTTAGAAATGACGGTATAGATAATACACATAATCCTGAATTTACTTCGTGTGAATTTTATTGGGCATATGCT	7
KRS5GAA	TATGAAATTGGTAAAGTATTTAGAAATGAAGGTATAGATAATACACATAATCCTGAATTTACTTCGTGTGAATTTTATTGGGCATATGCT	40702
KRS5GAG	TATGAAATTGGTAAAGTATTTAGAAATGAGGGTATAGATAATACACATAATCCTGAATTTACTTCGTGTGAATTTTATTGGGCATATGCT	126
KRS5TGT	TATGAAATTGGTAAAGTATTTAGAAATTGTGGTATAGATAATACACATAATCCTGAATTTACTTCGTGTGAATTTTATTGGGCATATGCT	10
KRS5TGC	TATGAAATTGGTAAAGTATTTAGAAATTGCGGTATAGATAATACACATAATCCTGAATTTACTTCGTGTGAATTTTATTGGGCATATGCT	3
KRS5TGA	TATGAAATTGGTAAAGTATTTAGAAATTGAGGTATAGATAATACACATAATCCTGAATTTACTTCGTGTGAATTTTATTGGGCATATGCT	1
KRS5TGG	TATGAAATTGGTAAAGTATTTAGAAATTGGGGTATAGATAATACACATAATCCTGAATTTACTTCGTGTGAATTTTATTGGGCATATGCT	5
KRS5CGT	TATGAAATTGGTAAAGTATTTAGAAATCGTGGTATAGATAATACACATAATCCTGAATTTACTTCGTGTGAATTTTATTGGGCATATGCT	0
KRS5CGC	TATGAAATTGGTAAAGTATTTAGAAATCGCGGTATAGATAATACACATAATCCTGAATTTACTTCGTGTGAATTTTATTGGGCATATGCT	2
KRS5CGA	TATGAAATTGGTAAAGTATTTAGAAATCGAGGTATAGATAATACACATAATCCTGAATTTACTTCGTGTGAATTTTATTGGGCATATGCT	1
KRS5CGG	TATGAAATTGGTAAAGTATTTAGAAATCGGGGTATAGATAATACACATAATCCTGAATTTACTTCGTGTGAATTTTATTGGGCATATGCT	1
KRS5AGT	TATGAAATTGGTAAAGTATTTAGAAATAGTGGTATAGATAATACACATAATCCTGAATTTACTTCGTGTGAATTTTATTGGGCATATGCT	3
KRS5AGC	TATGAAATTGGTAAAGTATTTAGAAATAGCGGTATAGATAATACACATAATCCTGAATTTACTTCGTGTGAATTTTATTGGGCATATGCT	3
KRS5AGA	TATGAAATTGGTAAAGTATTTAGAAATAGAGGTATAGATAATACACATAATCCTGAATTTACTTCGTGTGAATTTTATTGGGCATATGCT	2
KRS5AGG	TATGAAATTGGTAAAGTATTTAGAAATAGGGGTATAGATAATACACATAATCCTGAATTTACTTCGTGTGAATTTTATTGGGCATATGCT	5
KRS5GGT	TATGAAATTGGTAAAGTATTTAGAAATGGTGGTATAGATAATACACATAATCCTGAATTTACTTCGTGTGAATTTTATTGGGCATATGCT	2
KRS5GGC	TATGAAATTGGTAAAGTATTTAGAAATGGCGGTATAGATAATACACATAATCCTGAATTTACTTCGTGTGAATTTTATTGGGCATATGCT	2
KRS5GGA	TATGAAATTGGTAAAGTATTTAGAAATGGAGGTATAGATAATACACATAATCCTGAATTTACTTCGTGTGAATTTTATTGGGCATATGCT	110
KRS5GGG	TATGAAATTGGTAAAGTATTTAGAAATGGGGGTATAGATAATACACATAATCCTGAATTTACTTCGTGTGAATTTTATTGGGCATATGCT	0
KRS6TTT	TATGAAATTGGTAAAGTATTTAGAAATGAATTTATAGATAATACACATAATCCTGAATTTACTTCGTGTGAATTTTATTGGGCATATGCT	27
KRS6TTC	TATGAAATTGGTAAAGTATTTAGAAATGAATTCATAGATAATACACATAATCCTGAATTTACTTCGTGTGAATTTTATTGGGCATATGCT	3
KRS6TTA	TATGAAATTGGTAAAGTATTTAGAAATGAATTAATAGATAATACACATAATCCTGAATTTACTTCGTGTGAATTTTATTGGGCATATGCT	1
KRS6TTG	TATGAAATTGGTAAAGTATTTAGAAATGAATTGATAGATAATACACATAATCCTGAATTTACTTCGTGTGAATTTTATTGGGCATATGCT	1
KRS6CTT	TATGAAATTGGTAAAGTATTTAGAAATGAACTTATAGATAATACACATAATCCTGAATTTACTTCGTGTGAATTTTATTGGGCATATGCT	4
KRS6CTC	TATGAAATTGGTAAAGTATTTAGAAATGAACTCATAGATAATACACATAATCCTGAATTTACTTCGTGTGAATTTTATTGGGCATATGCT	0
KRS6CTA	TATGAAATTGGTAAAGTATTTAGAAATGAACTAATAGATAATACACATAATCCTGAATTTACTTCGTGTGAATTTTATTGGGCATATGCT	3
KRS6CTG	TATGAAATTGGTAAAGTATTTAGAAATGAACTGATAGATAATACACATAATCCTGAATTTACTTCGTGTGAATTTTATTGGGCATATGCT	0
KRS6ATT	TATGAAATTGGTAAAGTATTTAGAAATGAAATTATAGATAATACACATAATCCTGAATTTACTTCGTGTGAATTTTATTGGGCATATGCT	7
KRS6ATC	TATGAAATTGGTAAAGTATTTAGAAATGAAATCATAGATAATACACATAATCCTGAATTTACTTCGTGTGAATTTTATTGGGCATATGCT	0
KRS6ATA	TATGAAATTGGTAAAGTATTTAGAAATGAAATAATAGATAATACACATAATCCTGAATTTACTTCGTGTGAATTTTATTGGGCATATGCT	6
KRS6ATG	TATGAAATTGGTAAAGTATTTAGAAATGAAATGATAGATAATACACATAATCCTGAATTTACTTCGTGTGAATTTTATTGGGCATATGCT	1
KRS6GTT	TATGAAATTGGTAAAGTATTTAGAAATGAAGTTATAGATAATACACATAATCCTGAATTTACTTCGTGTGAATTTTATTGGGCATATGCT	35
KRS6GTC	TATGAAATTGGTAAAGTATTTAGAAATGAAGTCATAGATAATACACATAATCCTGAATTTACTTCGTGTGAATTTTATTGGGCATATGCT	0
KRS6GTA	TATGAAATTGGTAAAGTATTTAGAAATGAAGTAATAGATAATACACATAATCCTGAATTTACTTCGTGTGAATTTTATTGGGCATATGCT	1
KRS6GTG	TATGAAATTGGTAAAGTATTTAGAAATGAAGTGATAGATAATACACATAATCCTGAATTTACTTCGTGTGAATTTTATTGGGCATATGCT	3
KRS6TCT	TATGAAATTGGTAAAGTATTTAGAAATGAATCTATAGATAATACACATAATCCTGAATTTACTTCGTGTGAATTTTATTGGGCATATGCT	3
KRS6TCC	TATGAAATTGGTAAAGTATTTAGAAATGAATCCATAGATAATACACATAATCCTGAATTTACTTCGTGTGAATTTTATTGGGCATATGCT	1
KRS6TCA	TATGAAATTGGTAAAGTATTTAGAAATGAATCAATAGATAATACACATAATCCTGAATTTACTTCGTGTGAATTTTATTGGGCATATGCT	0
KRS6TCG	TATGAAATTGGTAAAGTATTTAGAAATGAATCGATAGATAATACACATAATCCTGAATTTACTTCGTGTGAATTTTATTGGGCATATGCT	0
KRS6CCT	TATGAAATTGGTAAAGTATTTAGAAATGAACCTATAGATAATACACATAATCCTGAATTTACTTCGTGTGAATTTTATTGGGCATATGCT	3
KRS6CCC	TATGAAATTGGTAAAGTATTTAGAAATGAACCCATAGATAATACACATAATCCTGAATTTACTTCGTGTGAATTTTATTGGGCATATGCT	1
KRS6CCA	TATGAAATTGGTAAAGTATTTAGAAATGAACCAATAGATAATACACATAATCCTGAATTTACTTCGTGTGAATTTTATTGGGCATATGCT	3
KRS6CCG	TATGAAATTGGTAAAGTATTTAGAAATGAACCGATAGATAATACACATAATCCTGAATTTACTTCGTGTGAATTTTATTGGGCATATGCT	1
KRS6ACT	TATGAAATTGGTAAAGTATTTAGAAATGAAACTATAGATAATACACATAATCCTGAATTTACTTCGTGTGAATTTTATTGGGCATATGCT	2
KRS6ACC	TATGAAATTGGTAAAGTATTTAGAAATGAAACCATAGATAATACACATAATCCTGAATTTACTTCGTGTGAATTTTATTGGGCATATGCT	2
KRS6ACA	TATGAAATTGGTAAAGTATTTAGAAATGAAACAATAGATAATACACATAATCCTGAATTTACTTCGTGTGAATTTTATTGGGCATATGCT	7
KRS6ACG	TATGAAATTGGTAAAGTATTTAGAAATGAAACGATAGATAATACACATAATCCTGAATTTACTTCGTGTGAATTTTATTGGGCATATGCT	4
KRS6GCT	TATGAAATTGGTAAAGTATTTAGAAATGAAGCTATAGATAATACACATAATCCTGAATTTACTTCGTGTGAATTTTATTGGGCATATGCT	33
KRS6GCC	TATGAAATTGGTAAAGTATTTAGAAATGAAGCCATAGATAATACACATAATCCTGAATTTACTTCGTGTGAATTTTATTGGGCATATGCT	2
KRS6GCA	TATGAAATTGGTAAAGTATTTAGAAATGAAGCAATAGATAATACACATAATCCTGAATTTACTTCGTGTGAATTTTATTGGGCATATGCT	3
KRS6GCG	TATGAAATTGGTAAAGTATTTAGAAATGAAGCGATAGATAATACACATAATCCTGAATTTACTTCGTGTGAATTTTATTGGGCATATGCT	2
KRS6TAT	TATGAAATTGGTAAAGTATTTAGAAATGAATATATAGATAATACACATAATCCTGAATTTACTTCGTGTGAATTTTATTGGGCATATGCT	5
KRS6TAC	TATGAAATTGGTAAAGTATTTAGAAATGAATACATAGATAATACACATAATCCTGAATTTACTTCGTGTGAATTTTATTGGGCATATGCT	4
KRS6TAA	TATGAAATTGGTAAAGTATTTAGAAATGAATAAATAGATAATACACATAATCCTGAATTTACTTCGTGTGAATTTTATTGGGCATATGCT	4
KRS6TAG	TATGAAATTGGTAAAGTATTTAGAAATGAATAGATAGATAATACACATAATCCTGAATTTACTTCGTGTGAATTTTATTGGGCATATGCT	1
KRS6CAT	TATGAAATTGGTAAAGTATTTAGAAATGAACATATAGATAATACACATAATCCTGAATTTACTTCGTGTGAATTTTATTGGGCATATGCT	1
KRS6CAC	TATGAAATTGGTAAAGTATTTAGAAATGAACACATAGATAATACACATAATCCTGAATTTACTTCGTGTGAATTTTATTGGGCATATGCT	2
KRS6CAA	TATGAAATTGGTAAAGTATTTAGAAATGAACAAATAGATAATACACATAATCCTGAATTTACTTCGTGTGAATTTTATTGGGCATATGCT	8
KRS6CAG	TATGAAATTGGTAAAGTATTTAGAAATGAACAGATAGATAATACACATAATCCTGAATTTACTTCGTGTGAATTTTATTGGGCATATGCT	1
KRS6AAT	TATGAAATTGGTAAAGTATTTAGAAATGAAAATATAGATAATACACATAATCCTGAATTTACTTCGTGTGAATTTTATTGGGCATATGCT	5
KRS6AAC	TATGAAATTGGTAAAGTATTTAGAAATGAAAACATAGATAATACACATAATCCTGAATTTACTTCGTGTGAATTTTATTGGGCATATGCT	7
KRS6AAA	TATGAAATTGGTAAAGTATTTAGAAATGAAAAAATAGATAATACACATAATCCTGAATTTACTTCGTGTGAATTTTATTGGGCATATGCT	3
KRS6AAG	TATGAAATTGGTAAAGTATTTAGAAATGAAAAGATAGATAATACACATAATCCTGAATTTACTTCGTGTGAATTTTATTGGGCATATGCT	0
KRS6GAT	TATGAAATTGGTAAAGTATTTAGAAATGAAGATATAGATAATACACATAATCCTGAATTTACTTCGTGTGAATTTTATTGGGCATATGCT	18
KRS6GAC	TATGAAATTGGTAAAGTATTTAGAAATGAAGACATAGATAATACACATAATCCTGAATTTACTTCGTGTGAATTTTATTGGGCATATGCT	0
KRS6GAA	TATGAAATTGGTAAAGTATTTAGAAATGAAGAAATAGATAATACACATAATCCTGAATTTACTTCGTGTGAATTTTATTGGGCATATGCT	1
KRS6GAG	TATGAAATTGGTAAAGTATTTAGAAATGAAGAGATAGATAATACACATAATCCTGAATTTACTTCGTGTGAATTTTATTGGGCATATGCT	1
KRS6TGT	TATGAAATTGGTAAAGTATTTAGAAATGAATGTATAGATAATACACATAATCCTGAATTTACTTCGTGTGAATTTTATTGGGCATATGCT	19
KRS6TGC	TATGAAATTGGTAAAGTATTTAGAAATGAATGCATAGATAATACACATAATCCTGAATTTACTTCGTGTGAATTTTATTGGGCATATGCT	2
KRS6TGA	TATGAAATTGGTAAAGTATTTAGAAATGAATGAATAGATAATACACATAATCCTGAATTTACTTCGTGTGAATTTTATTGGGCATATGCT	5
KRS6TGG	TATGAAATTGGTAAAGTATTTAGAAATGAATGGATAGATAATACACATAATCCTGAATTTACTTCGTGTGAATTTTATTGGGCATATGCT	1
KRS6CGT	TATGAAATTGGTAAAGTATTTAGAAATGAACGTATAGATAATACACATAATCCTGAATTTACTTCGTGTGAATTTTATTGGGCATATGCT	20
KRS6CGC	TATGAAATTGGTAAAGTATTTAGAAATGAACGCATAGATAATACACATAATCCTGAATTTACTTCGTGTGAATTTTATTGGGCATATGCT	1
KRS6CGA	TATGAAATTGGTAAAGTATTTAGAAATGAACGAATAGATAATACACATAATCCTGAATTTACTTCGTGTGAATTTTATTGGGCATATGCT	2
KRS6CGG	TATGAAATTGGTAAAGTATTTAGAAATGAACGGATAGATAATACACATAATCCTGAATTTACTTCGTGTGAATTTTATTGGGCATATGCT	3
KRS6AGT	TATGAAATTGGTAAAGTATTTAGAAATGAAAGTATAGATAATACACATAATCCTGAATTTACTTCGTGTGAATTTTATTGGGCATATGCT	19
KRS6AGC	TATGAAATTGGTAAAGTATTTAGAAATGAAAGCATAGATAATACACATAATCCTGAATTTACTTCGTGTGAATTTTATTGGGCATATGCT	1
KRS6AGA	TATGAAATTGGTAAAGTATTTAGAAATGAAAGAATAGATAATACACATAATCCTGAATTTACTTCGTGTGAATTTTATTGGGCATATGCT	5
KRS6AGG	TATGAAATTGGTAAAGTATTTAGAAATGAAAGGATAGATAATACACATAATCCTGAATTTACTTCGTGTGAATTTTATTGGGCATATGCT	0
KRS6GGT	TATGAAATTGGTAAAGTATTTAGAAATGAAGGTATAGATAATACACATAATCCTGAATTTACTTCGTGTGAATTTTATTGGGCATATGCT	40702
KRS6GGC	TATGAAATTGGTAAAGTATTTAGAAATGAAGGCATAGATAATACACATAATCCTGAATTTACTTCGTGTGAATTTTATTGGGCATATGCT	45
KRS6GGA	TATGAAATTGGTAAAGTATTTAGAAATGAAGGAATAGATAATACACATAATCCTGAATTTACTTCGTGTGAATTTTATTGGGCATATGCT	51
KRS6GGG	TATGAAATTGGTAAAGTATTTAGAAATGAAGGGATAGATAATACACATAATCCTGAATTTACTTCGTGTGAATTTTATTGGGCATATGCT	14
KRS7TTT	TATGAAATTGGTAAAGTATTTAGAAATGAAGGTTTTGATAATACACATAATCCTGAATTTACTTCGTGTGAATTTTATTGGGCATATGCT	17
KRS7TTC	TATGAAATTGGTAAAGTATTTAGAAATGAAGGTTTCGATAATACACATAATCCTGAATTTACTTCGTGTGAATTTTATTGGGCATATGCT	251
KRS7TTA	TATGAAATTGGTAAAGTATTTAGAAATGAAGGTTTAGATAATACACATAATCCTGAATTTACTTCGTGTGAATTTTATTGGGCATATGCT	21
KRS7TTG	TATGAAATTGGTAAAGTATTTAGAAATGAAGGTTTGGATAATACACATAATCCTGAATTTACTTCGTGTGAATTTTATTGGGCATATGCT	254
KRS7CTT	TATGAAATTGGTAAAGTATTTAGAAATGAAGGTCTTGATAATACACATAATCCTGAATTTACTTCGTGTGAATTTTATTGGGCATATGCT	6
KRS7CTC	TATGAAATTGGTAAAGTATTTAGAAATGAAGGTCTCGATAATACACATAATCCTGAATTTACTTCGTGTGAATTTTATTGGGCATATGCT	4
KRS7CTA	TATGAAATTGGTAAAGTATTTAGAAATGAAGGTCTAGATAATACACATAATCCTGAATTTACTTCGTGTGAATTTTATTGGGCATATGCT	2
KRS7CTG	TATGAAATTGGTAAAGTATTTAGAAATGAAGGTCTGGATAATACACATAATCCTGAATTTACTTCGTGTGAATTTTATTGGGCATATGCT	0
KRS7ATT	TATGAAATTGGTAAAGTATTTAGAAATGAAGGTATTGATAATACACATAATCCTGAATTTACTTCGTGTGAATTTTATTGGGCATATGCT	18
KRS7ATC	TATGAAATTGGTAAAGTATTTAGAAATGAAGGTATCGATAATACACATAATCCTGAATTTACTTCGTGTGAATTTTATTGGGCATATGCT	6
KRS7ATA	TATGAAATTGGTAAAGTATTTAGAAATGAAGGTATAGATAATACACATAATCCTGAATTTACTTCGTGTGAATTTTATTGGGCATATGCT	40702
KRS7ATG	TATGAAATTGGTAAAGTATTTAGAAATGAAGGTATGGATAATACACATAATCCTGAATTTACTTCGTGTGAATTTTATTGGGCATATGCT	78
KRS7GTT	TATGAAATTGGTAAAGTATTTAGAAATGAAGGTGTTGATAATACACATAATCCTGAATTTACTTCGTGTGAATTTTATTGGGCATATGCT	0
KRS7GTC	TATGAAATTGGTAAAGTATTTAGAAATGAAGGTGTCGATAATACACATAATCCTGAATTTACTTCGTGTGAATTTTATTGGGCATATGCT	0
KRS7GTA	TATGAAATTGGTAAAGTATTTAGAAATGAAGGTGTAGATAATACACATAATCCTGAATTTACTTCGTGTGAATTTTATTGGGCATATGCT	60
KRS7GTG	TATGAAATTGGTAAAGTATTTAGAAATGAAGGTGTGGATAATACACATAATCCTGAATTTACTTCGTGTGAATTTTATTGGGCATATGCT	3
KRS7TCT	TATGAAATTGGTAAAGTATTTAGAAATGAAGGTTCTGATAATACACATAATCCTGAATTTACTTCGTGTGAATTTTATTGGGCATATGCT	4
KRS7TCC	TATGAAATTGGTAAAGTATTTAGAAATGAAGGTTCCGATAATACACATAATCCTGAATTTACTTCGTGTGAATTTTATTGGGCATATGCT	4
KRS7TCA	TATGAAATTGGTAAAGTATTTAGAAATGAAGGTTCAGATAATACACATAATCCTGAATTTACTTCGTGTGAATTTTATTGGGCATATGCT	1
KRS7TCG	TATGAAATTGGTAAAGTATTTAGAAATGAAGGTTCGGATAATACACATAATCCTGAATTTACTTCGTGTGAATTTTATTGGGCATATGCT	0
KRS7CCT	TATGAAATTGGTAAAGTATTTAGAAATGAAGGTCCTGATAATACACATAATCCTGAATTTACTTCGTGTGAATTTTATTGGGCATATGCT	3
KRS7CCC	TATGAAATTGGTAAAGTATTTAGAAATGAAGGTCCCGATAATACACATAATCCTGAATTTACTTCGTGTGAATTTTATTGGGCATATGCT	1
KRS7CCA	TATGAAATTGGTAAAGTATTTAGAAATGAAGGTCCAGATAATACACATAATCCTGAATTTACTTCGTGTGAATTTTATTGGGCATATGCT	2
KRS7CCG	TATGAAATTGGTAAAGTATTTAGAAATGAAGGTCCGGATAATACACATAATCCTGAATTTACTTCGTGTGAATTTTATTGGGCATATGCT	0
KRS7ACT	TATGAAATTGGTAAAGTATTTAGAAATGAAGGTACTGATAATACACATAATCCTGAATTTACTTCGTGTGAATTTTATTGGGCATATGCT	0
KRS7ACC	TATGAAATTGGTAAAGTATTTAGAAATGAAGGTACCGATAATACACATAATCCTGAATTTACTTCGTGTGAATTTTATTGGGCATATGCT	6
KRS7ACA	TATGAAATTGGTAAAGTATTTAGAAATGAAGGTACAGATAATACACATAATCCTGAATTTACTTCGTGTGAATTTTATTGGGCATATGCT	65
KRS7ACG	TATGAAATTGGTAAAGTATTTAGAAATGAAGGTACGGATAATACACATAATCCTGAATTTACTTCGTGTGAATTTTATTGGGCATATGCT	0
KRS7GCT	TATGAAATTGGTAAAGTATTTAGAAATGAAGGTGCTGATAATACACATAATCCTGAATTTACTTCGTGTGAATTTTATTGGGCATATGCT	0
KRS7GCC	TATGAAATTGGTAAAGTATTTAGAAATGAAGGTGCCGATAATACACATAATCCTGAATTTACTTCGTGTGAATTTTATTGGGCATATGCT	3
KRS7GCA	TATGAAATTGGTAAAGTATTTAGAAATGAAGGTGCAGATAATACACATAATCCTGAATTTACTTCGTGTGAATTTTATTGGGCATATGCT	2
KRS7GCG	TATGAAATTGGTAAAGTATTTAGAAATGAAGGTGCGGATAATACACATAATCCTGAATTTACTTCGTGTGAATTTTATTGGGCATATGCT	0
KRS7TAT	TATGAAATTGGTAAAGTATTTAGAAATGAAGGTTATGATAATACACATAATCCTGAATTTACTTCGTGTGAATTTTATTGGGCATATGCT	3
KRS7TAC	TATGAAATTGGTAAAGTATTTAGAAATGAAGGTTACGATAATACACATAATCCTGAATTTACTTCGTGTGAATTTTATTGGGCATATGCT	0
KRS7TAA	TATGAAATTGGTAAAGTATTTAGAAATGAAGGTTAAGATAATACACATAATCCTGAATTTACTTCGTGTGAATTTTATTGGGCATATGCT	6
KRS7TAG	TATGAAATTGGTAAAGTATTTAGAAATGAAGGTTAGGATAATACACATAATCCTGAATTTACTTCGTGTGAATTTTATTGGGCATATGCT	3
KRS7CAT	TATGAAATTGGTAAAGTATTTAGAAATGAAGGTCATGATAATACACATAATCCTGAATTTACTTCGTGTGAATTTTATTGGGCATATGCT	0
KRS7CAC	TATGAAATTGGTAAAGTATTTAGAAATGAAGGTCACGATAATACACATAATCCTGAATTTACTTCGTGTGAATTTTATTGGGCATATGCT	1
KRS7CAA	TATGAAATTGGTAAAGTATTTAGAAATGAAGGTCAAGATAATACACATAATCCTGAATTTACTTCGTGTGAATTTTATTGGGCATATGCT	4
KRS7CAG	TATGAAATTGGTAAAGTATTTAGAAATGAAGGTCAGGATAATACACATAATCCTGAATTTACTTCGTGTGAATTTTATTGGGCATATGCT	10
KRS7AAT	TATGAAATTGGTAAAGTATTTAGAAATGAAGGTAATGATAATACACATAATCCTGAATTTACTTCGTGTGAATTTTATTGGGCATATGCT	0
KRS7AAC	TATGAAATTGGTAAAGTATTTAGAAATGAAGGTAACGATAATACACATAATCCTGAATTTACTTCGTGTGAATTTTATTGGGCATATGCT	4
KRS7AAA	TATGAAATTGGTAAAGTATTTAGAAATGAAGGTAAAGATAATACACATAATCCTGAATTTACTTCGTGTGAATTTTATTGGGCATATGCT	44
KRS7AAG	TATGAAATTGGTAAAGTATTTAGAAATGAAGGTAAGGATAATACACATAATCCTGAATTTACTTCGTGTGAATTTTATTGGGCATATGCT	1
KRS7GAT	TATGAAATTGGTAAAGTATTTAGAAATGAAGGTGATGATAATACACATAATCCTGAATTTACTTCGTGTGAATTTTATTGGGCATATGCT	2
KRS7GAC	TATGAAATTGGTAAAGTATTTAGAAATGAAGGTGACGATAATACACATAATCCTGAATTTACTTCGTGTGAATTTTATTGGGCATATGCT	0
KRS7GAA	TATGAAATTGGTAAAGTATTTAGAAATGAAGGTGAAGATAATACACATAATCCTGAATTTACTTCGTGTGAATTTTATTGGGCATATGCT	2247
KRS7GAG	TATGAAATTGGTAAAGTATTTAGAAATGAAGGTGAGGATAATACACATAATCCTGAATTTACTTCGTGTGAATTTTATTGGGCATATGCT	1
KRS7TGT	TATGAAATTGGTAAAGTATTTAGAAATGAAGGTTGTGATAATACACATAATCCTGAATTTACTTCGTGTGAATTTTATTGGGCATATGCT	0
KRS7TGC	TATGAAATTGGTAAAGTATTTAGAAATGAAGGTTGCGATAATACACATAATCCTGAATTTACTTCGTGTGAATTTTATTGGGCATATGCT	2
KRS7TGA	TATGAAATTGGTAAAGTATTTAGAAATGAAGGTTGAGATAATACACATAATCCTGAATTTACTTCGTGTGAATTTTATTGGGCATATGCT	1
KRS7TGG	TATGAAATTGGTAAAGTATTTAGAAATGAAGGTTGGGATAATACACATAATCCTGAATTTACTTCGTGTGAATTTTATTGGGCATATGCT	5
KRS7CGT	TATGAAATTGGTAAAGTATTTAGAAATGAAGGTCGTGATAATACACATAATCCTGAATTTACTTCGTGTGAATTTTATTGGGCATATGCT	0
KRS7CGC	TATGAAATTGGTAAAGTATTTAGAAATGAAGGTCGCGATAATACACATAATCCTGAATTTACTTCGTGTGAATTTTATTGGGCATATGCT	0
KRS7CGA	TATGAAATTGGTAAAGTATTTAGAAATGAAGGTCGAGATAATACACATAATCCTGAATTTACTTCGTGTGAATTTTATTGGGCATATGCT	1
KRS7CGG	TATGAAATTGGTAAAGTATTTAGAAATGAAGGTCGGGATAATACACATAATCCTGAATTTACTTCGTGTGAATTTTATTGGGCATATGCT	0
KRS7AGT	TATGAAATTGGTAAAGTATTTAGAAATGAAGGTAGTGATAATACACATAATCCTGAATTTACTTCGTGTGAATTTTATTGGGCATATGCT	0
KRS7AGC	TATGAAATTGGTAAAGTATTTAGAAATGAAGGTAGCGATAATACACATAATCCTGAATTTACTTCGTGTGAATTTTATTGGGCATATGCT	1
KRS7AGA	TATGAAATTGGTAAAGTATTTAGAAATGAAGGTAGAGATAATACACATAATCCTGAATTTACTTCGTGTGAATTTTATTGGGCATATGCT	13
KRS7AGG	TATGAAATTGGTAAAGTATTTAGAAATGAAGGTAGGGATAATACACATAATCCTGAATTTACTTCGTGTGAATTTTATTGGGCATATGCT	0
KRS7GGT	TATGAAATTGGTAAAGTATTTAGAAATGAAGGTGGTGATAATACACATAATCCTGAATTTACTTCGTGTGAATTTTATTGGGCATATGCT	1
KRS7GGC	TATGAAATTGGTAAAGTATTTAGAAATGAAGGTGGCGATAATACACATAATCCTGAATTTACTTCGTGTGAATTTTATTGGGCATATGCT	0
KRS7GGA	TATGAAATTGGTAAAGTATTTAGAAATGAAGGTGGAGATAATACACATAATCCTGAATTTACTTCGTGTGAATTTTATTGGGCATATGCT	9
KRS7GGG	TATGAAATTGGTAAAGTATTTAGAAATGAAGGTGGGGATAATACACATAATCCTGAATTTACTTCGTGTGAATTTTATTGGGCATATGCT	1
KRS8TTT	TATGAAATTGGTAAAGTATTTAGAAATGAAGGTATATTTAATACACATAATCCTGAATTTACTTCGTGTGAATTTTATTGGGCATATGCT	6
KRS8TTC	TATGAAATTGGTAAAGTATTTAGAAATGAAGGTATATTCAATACACATAATCCTGAATTTACTTCGTGTGAATTTTATTGGGCATATGCT	7
KRS8TTA	TATGAAATTGGTAAAGTATTTAGAAATGAAGGTATATTAAATACACATAATCCTGAATTTACTTCGTGTGAATTTTATTGGGCATATGCT	8
KRS8TTG	TATGAAATTGGTAAAGTATTTAGAAATGAAGGTATATTGAATACACATAATCCTGAATTTACTTCGTGTGAATTTTATTGGGCATATGCT	2
KRS8CTT	TATGAAATTGGTAAAGTATTTAGAAATGAAGGTATACTTAATACACATAATCCTGAATTTACTTCGTGTGAATTTTATTGGGCATATGCT	0
KRS8CTC	TATGAAATTGGTAAAGTATTTAGAAATGAAGGTATACTCAATACACATAATCCTGAATTTACTTCGTGTGAATTTTATTGGGCATATGCT	1
KRS8CTA	TATGAAATTGGTAAAGTATTTAGAAATGAAGGTATACTAAATACACATAATCCTGAATTTACTTCGTGTGAATTTTATTGGGCATATGCT	3
KRS8CTG	TATGAAATTGGTAAAGTATTTAGAAATGAAGGTATACTGAATACACATAATCCTGAATTTACTTCGTGTGAATTTTATTGGGCATATGCT	1
KRS8ATT	TATGAAATTGGTAAAGTATTTAGAAATGAAGGTATAATTAATACACATAATCCTGAATTTACTTCGTGTGAATTTTATTGGGCATATGCT	2
KRS8ATC	TATGAAATTGGTAAAGTATTTAGAAATGAAGGTATAATCAATACACATAATCCTGAATTTACTTCGTGTGAATTTTATTGGGCATATGCT	1
KRS8ATA	TATGAAATTGGTAAAGTATTTAGAAATGAAGGTATAATAAATACACATAATCCTGAATTTACTTCGTGTGAATTTTATTGGGCATATGCT	4
KRS8ATG	TATGAAATTGGTAAAGTATTTAGAAATGAAGGTATAATGAATACACATAATCCTGAATTTACTTCGTGTGAATTTTATTGGGCATATGCT	0
KRS8GTT	TATGAAATTGGTAAAGTATTTAGAAATGAAGGTATAGTTAATACACATAATCCTGAATTTACTTCGTGTGAATTTTATTGGGCATATGCT	33
KRS8GTC	TATGAAATTGGTAAAGTATTTAGAAATGAAGGTATAGTCAATACACATAATCCTGAATTTACTTCGTGTGAATTTTATTGGGCATATGCT	0
KRS8GTA	TATGAAATTGGTAAAGTATTTAGAAATGAAGGTATAGTAAATACACATAATCCTGAATTTACTTCGTGTGAATTTTATTGGGCATATGCT	0
KRS8GTG	TATGAAATTGGTAAAGTATTTAGAAATGAAGGTATAGTGAATACACATAATCCTGAATTTACTTCGTGTGAATTTTATTGGGCATATGCT	1
KRS8TCT	TATGAAATTGGTAAAGTATTTAGAAATGAAGGTATATCTAATACACATAATCCTGAATTTACTTCGTGTGAATTTTATTGGGCATATGCT	0
KRS8TCC	TATGAAATTGGTAAAGTATTTAGAAATGAAGGTATATCCAATACACATAATCCTGAATTTACTTCGTGTGAATTTTATTGGGCATATGCT	4
KRS8TCA	TATGAAATTGGTAAAGTATTTAGAAATGAAGGTATATCAAATACACATAATCCTGAATTTACTTCGTGTGAATTTTATTGGGCATATGCT	2
KRS8TCG	TATGAAATTGGTAAAGTATTTAGAAATGAAGGTATATCGAATACACATAATCCTGAATTTACTTCGTGTGAATTTTATTGGGCATATGCT	0
KRS8CCT	TATGAAATTGGTAAAGTATTTAGAAATGAAGGTATACCTAATACACATAATCCTGAATTTACTTCGTGTGAATTTTATTGGGCATATGCT	0
KRS8CCC	TATGAAATTGGTAAAGTATTTAGAAATGAAGGTATACCCAATACACATAATCCTGAATTTACTTCGTGTGAATTTTATTGGGCATATGCT	2
KRS8CCA	TATGAAATTGGTAAAGTATTTAGAAATGAAGGTATACCAAATACACATAATCCTGAATTTACTTCGTGTGAATTTTATTGGGCATATGCT	0
KRS8CCG	TATGAAATTGGTAAAGTATTTAGAAATGAAGGTATACCGAATACACATAATCCTGAATTTACTTCGTGTGAATTTTATTGGGCATATGCT	0
KRS8ACT	TATGAAATTGGTAAAGTATTTAGAAATGAAGGTATAACTAATACACATAATCCTGAATTTACTTCGTGTGAATTTTATTGGGCATATGCT	0
KRS8ACC	TATGAAATTGGTAAAGTATTTAGAAATGAAGGTATAACCAATACACATAATCCTGAATTTACTTCGTGTGAATTTTATTGGGCATATGCT	0
KRS8ACA	TATGAAATTGGTAAAGTATTTAGAAATGAAGGTATAACAAATACACATAATCCTGAATTTACTTCGTGTGAATTTTATTGGGCATATGCT	1
KRS8ACG	TATGAAATTGGTAAAGTATTTAGAAATGAAGGTATAACGAATACACATAATCCTGAATTTACTTCGTGTGAATTTTATTGGGCATATGCT	0
KRS8GCT	TATGAAATTGGTAAAGTATTTAGAAATGAAGGTATAGCTAATACACATAATCCTGAATTTACTTCGTGTGAATTTTATTGGGCATATGCT	3
KRS8GCC	TATGAAATTGGTAAAGTATTTAGAAATGAAGGTATAGCCAATACACATAATCCTGAATTTACTTCGTGTGAATTTTATTGGGCATATGCT	0
KRS8GCA	TATGAAATTGGTAAAGTATTTAGAAATGAAGGTATAGCAAATACACATAATCCTGAATTTACTTCGTGTGAATTTTATTGGGCATATGCT	0
KRS8GCG	TATGAAATTGGTAAAGTATTTAGAAATGAAGGTATAGCGAATACACATAATCCTGAATTTACTTCGTGTGAATTTTATTGGGCATATGCT	0
KRS8TAT	TATGAAATTGGTAAAGTATTTAGAAATGAAGGTATATATAATACACATAATCCTGAATTTACTTCGTGTGAATTTTATTGGGCATATGCT	10
KRS8TAC	TATGAAATTGGTAAAGTATTTAGAAATGAAGGTATATACAATACACATAATCCTGAATTTACTTCGTGTGAATTTTATTGGGCATATGCT	2
KRS8TAA	TATGAAATTGGTAAAGTATTTAGAAATGAAGGTATATAAAATACACATAATCCTGAATTTACTTCGTGTGAATTTTATTGGGCATATGCT	7
KRS8TAG	TATGAAATTGGTAAAGTATTTAGAAATGAAGGTATATAGAATACACATAATCCTGAATTTACTTCGTGTGAATTTTATTGGGCATATGCT	0
KRS8CAT	TATGAAATTGGTAAAGTATTTAGAAATGAAGGTATACATAATACACATAATCCTGAATTTACTTCGTGTGAATTTTATTGGGCATATGCT	29
KRS8CAC	TATGAAATTGGTAAAGTATTTAGAAATGAAGGTATACACAATACACATAATCCTGAATTTACTTCGTGTGAATTTTATTGGGCATATGCT	0
KRS8CAA	TATGAAATTGGTAAAGTATTTAGAAATGAAGGTATACAAAATACACATAATCCTGAATTTACTTCGTGTGAATTTTATTGGGCATATGCT	4
KRS8CAG	TATGAAATTGGTAAAGTATTTAGAAATGAAGGTATACAGAATACACATAATCCTGAATTTACTTCGTGTGAATTTTATTGGGCATATGCT	0
KRS8AAT	TATGAAATTGGTAAAGTATTTAGAAATGAAGGTATAAATAATACACATAATCCTGAATTTACTTCGTGTGAATTTTATTGGGCATATGCT	21
KRS8AAC	TATGAAATTGGTAAAGTATTTAGAAATGAAGGTATAAACAATACACATAATCCTGAATTTACTTCGTGTGAATTTTATTGGGCATATGCT	2
KRS8AAA	TATGAAATTGGTAAAGTATTTAGAAATGAAGGTATAAAAAATACACATAATCCTGAATTTACTTCGTGTGAATTTTATTGGGCATATGCT	25
KRS8AAG	TATGAAATTGGTAAAGTATTTAGAAATGAAGGTATAAAGAATACACATAATCCTGAATTTACTTCGTGTGAATTTTATTGGGCATATGCT	0
KRS8GAT	TATGAAATTGGTAAAGTATTTAGAAATGAAGGTATAGATAATACACATAATCCTGAATTTACTTCGTGTGAATTTTATTGGGCATATGCT	40702
KRS8GAC	TATGAAATTGGTAAAGTATTTAGAAATGAAGGTATAGACAATACACATAATCCTGAATTTACTTCGTGTGAATTTTATTGGGCATATGCT	53
KRS8GAA	TATGAAATTGGTAAAGTATTTAGAAATGAAGGTATAGAAAATACACATAATCCTGAATTTACTTCGTGTGAATTTTATTGGGCATATGCT	15
KRS8GAG	TATGAAATTGGTAAAGTATTTAGAAATGAAGGTATAGAGAATACACATAATCCTGAATTTACTTCGTGTGAATTTTATTGGGCATATGCT	3
KRS8TGT	TATGAAATTGGTAAAGTATTTAGAAATGAAGGTATATGTAATACACATAATCCTGAATTTACTTCGTGTGAATTTTATTGGGCATATGCT	1
KRS8TGC	TATGAAATTGGTAAAGTATTTAGAAATGAAGGTATATGCAATACACATAATCCTGAATTTACTTCGTGTGAATTTTATTGGGCATATGCT	2
KRS8TGA	TATGAAATTGGTAAAGTATTTAGAAATGAAGGTATATGAAATACACATAATCCTGAATTTACTTCGTGTGAATTTTATTGGGCATATGCT	1
KRS8TGG	TATGAAATTGGTAAAGTATTTAGAAATGAAGGTATATGGAATACACATAATCCTGAATTTACTTCGTGTGAATTTTATTGGGCATATGCT	0
KRS8CGT	TATGAAATTGGTAAAGTATTTAGAAATGAAGGTATACGTAATACACATAATCCTGAATTTACTTCGTGTGAATTTTATTGGGCATATGCT	1
KRS8CGC	TATGAAATTGGTAAAGTATTTAGAAATGAAGGTATACGCAATACACATAATCCTGAATTTACTTCGTGTGAATTTTATTGGGCATATGCT	0
KRS8CGA	TATGAAATTGGTAAAGTATTTAGAAATGAAGGTATACGAAATACACATAATCCTGAATTTACTTCGTGTGAATTTTATTGGGCATATGCT	0
KRS8CGG	TATGAAATTGGTAAAGTATTTAGAAATGAAGGTATACGGAATACACATAATCCTGAATTTACTTCGTGTGAATTTTATTGGGCATATGCT	0
KRS8AGT	TATGAAATTGGTAAAGTATTTAGAAATGAAGGTATAAGTAATACACATAATCCTGAATTTACTTCGTGTGAATTTTATTGGGCATATGCT	0
KRS8AGC	TATGAAATTGGTAAAGTATTTAGAAATGAAGGTATAAGCAATACACATAATCCTGAATTTACTTCGTGTGAATTTTATTGGGCATATGCT	0
KRS8AGA	TATGAAATTGGTAAAGTATTTAGAAATGAAGGTATAAGAAATACACATAATCCTGAATTTACTTCGTGTGAATTTTATTGGGCATATGCT	8
KRS8AGG	TATGAAATTGGTAAAGTATTTAGAAATGAAGGTATAAGGAATACACATAATCCTGAATTTACTTCGTGTGAATTTTATTGGGCATATGCT	0
KRS8GGT	TATGAAATTGGTAAAGTATTTAGAAATGAAGGTATAGGTAATACACATAATCCTGAATTTACTTCGTGTGAATTTTATTGGGCATATGCT	102
KRS8GGC	TATGAAATTGGTAAAGTATTTAGAAATGAAGGTATAGGCAATACACATAATCCTGAATTTACTTCGTGTGAATTTTATTGGGCATATGCT	0
KRS8GGA	TATGAAATTGGTAAAGTATTTAGAAATGAAGGTATAGGAAATACACATAATCCTGAATTTACTTCGTGTGAATTTTATTGGGCATATGCT	0
KRS8GGG	TATGAAATTGGTAAAGTATTTAGAAATGAAGGTATAGGGAATACACATAATCCTGAATTTACTTCGTGTGAATTTTATTGGGCATATGCT	0
KRS9TTT	TATGAAATTGGTAAAGTATTTAGAAATGAAGGTATAGATTTTACACATAATCCTGAATTTACTTCGTGTGAATTTTATTGGGCATATGCT	342
KRS9TTC	TATGAAATTGGTAAAGTATTTAGAAATGAAGGTATAGATTTCACACATAATCCTGAATTTACTTCGTGTGAATTTTATTGGGCATATGCT	11
KRS9TTA	TATGAAATTGGTAAAGTATTTAGAAATGAAGGTATAGATTTAACACATAATCCTGAATTTACTTCGTGTGAATTTTATTGGGCATATGCT	16
KRS9TTG	TATGAAATTGGTAAAGTATTTAGAAATGAAGGTATAGATTTGACACATAATCCTGAATTTACTTCGTGTGAATTTTATTGGGCATATGCT	10
KRS9CTT	TATGAAATTGGTAAAGTATTTAGAAATGAAGGTATAGATCTTACACATAATCCTGAATTTACTTCGTGTGAATTTTATTGGGCATATGCT	304
KRS9CTC	TATGAAATTGGTAAAGTATTTAGAAATGAAGGTATAGATCTCACACATAATCCTGAATTTACTTCGTGTGAATTTTATTGGGCATATGCT	2
KRS9CTA	TATGAAATTGGTAAAGTATTTAGAAATGAAGGTATAGATCTAACACATAATCCTGAATTTACTTCGTGTGAATTTTATTGGGCATATGCT	107
KRS9CTG	TATGAAATTGGTAAAGTATTTAGAAATGAAGGTATAGATCTGACACATAATCCTGAATTTACTTCGTGTGAATTTTATTGGGCATATGCT	2
KRS9ATT	TATGAAATTGGTAAAGTATTTAGAAATGAAGGTATAGATATTACACATAATCCTGAATTTACTTCGTGTGAATTTTATTGGGCATATGCT	32
KRS9ATC	TATGAAATTGGTAAAGTATTTAGAAATGAAGGTATAGATATCACACATAATCCTGAATTTACTTCGTGTGAATTTTATTGGGCATATGCT	5
KRS9ATA	TATGAAATTGGTAAAGTATTTAGAAATGAAGGTATAGATATAACACATAATCCTGAATTTACTTCGTGTGAATTTTATTGGGCATATGCT	72
KRS9ATG	TATGAAATTGGTAAAGTATTTAGAAATGAAGGTATAGATATGACACATAATCCTGAATTTACTTCGTGTGAATTTTATTGGGCATATGCT	0
KRS9GTT	TATGAAATTGGTAAAGTATTTAGAAATGAAGGTATAGATGTTACACATAATCCTGAATTTACTTCGTGTGAATTTTATTGGGCATATGCT	8
KRS9GTC	TATGAAATTGGTAAAGTATTTAGAAATGAAGGTATAGATGTCACACATAATCCTGAATTTACTTCGTGTGAATTTTATTGGGCATATGCT	4
KRS9GTA	TATGAAATTGGTAAAGTATTTAGAAATGAAGGTATAGATGTAACACATAATCCTGAATTTACTTCGTGTGAATTTTATTGGGCATATGCT	0
KRS9GTG	TATGAAATTGGTAAAGTATTTAGAAATGAAGGTATAGATGTGACACATAATCCTGAATTTACTTCGTGTGAATTTTATTGGGCATATGCT	3
KRS9TCT	TATGAAATTGGTAAAGTATTTAGAAATGAAGGTATAGATTCTACACATAATCCTGAATTTACTTCGTGTGAATTTTATTGGGCATATGCT	6
KRS9TCC	TATGAAATTGGTAAAGTATTTAGAAATGAAGGTATAGATTCCACACATAATCCTGAATTTACTTCGTGTGAATTTTATTGGGCATATGCT	2
KRS9TCA	TATGAAATTGGTAAAGTATTTAGAAATGAAGGTATAGATTCAACACATAATCCTGAATTTACTTCGTGTGAATTTTATTGGGCATATGCT	7
KRS9TCG	TATGAAATTGGTAAAGTATTTAGAAATGAAGGTATAGATTCGACACATAATCCTGAATTTACTTCGTGTGAATTTTATTGGGCATATGCT	1
KRS9CCT	TATGAAATTGGTAAAGTATTTAGAAATGAAGGTATAGATCCTACACATAATCCTGAATTTACTTCGTGTGAATTTTATTGGGCATATGCT	17
KRS9CCC	TATGAAATTGGTAAAGTATTTAGAAATGAAGGTATAGATCCCACACATAATCCTGAATTTACTTCGTGTGAATTTTATTGGGCATATGCT	0
KRS9CCA	TATGAAATTGGTAAAGTATTTAGAAATGAAGGTATAGATCCAACACATAATCCTGAATTTACTTCGTGTGAATTTTATTGGGCATATGCT	2
KRS9CCG	TATGAAATTGGTAAAGTATTTAGAAATGAAGGTATAGATCCGACACATAATCCTGAATTTACTTCGTGTGAATTTTATTGGGCATATGCT	0
KRS9ACT	TATGAAATTGGTAAAGTATTTAGAAATGAAGGTATAGATACTACACATAATCCTGAATTTACTTCGTGTGAATTTTATTGGGCATATGCT	16
KRS9ACC	TATGAAATTGGTAAAGTATTTAGAAATGAAGGTATAGATACCACACATAATCCTGAATTTACTTCGTGTGAATTTTATTGGGCATATGCT	5
KRS9ACA	TATGAAATTGGTAAAGTATTTAGAAATGAAGGTATAGATACAACACATAATCCTGAATTTACTTCGTGTGAATTTTATTGGGCATATGCT	20
KRS9ACG	TATGAAATTGGTAAAGTATTTAGAAATGAAGGTATAGATACGACACATAATCCTGAATTTACTTCGTGTGAATTTTATTGGGCATATGCT	0
KRS9GCT	TATGAAATTGGTAAAGTATTTAGAAATGAAGGTATAGATGCTACACATAATCCTGAATTTACTTCGTGTGAATTTTATTGGGCATATGCT	3
KRS9GCC	TATGAAATTGGTAAAGTATTTAGAAATGAAGGTATAGATGCCACACATAATCCTGAATTTACTTCGTGTGAATTTTATTGGGCATATGCT	0
KRS9GCA	TATGAAATTGGTAAAGTATTTAGAAATGAAGGTATAGATGCAACACATAATCCTGAATTTACTTCGTGTGAATTTTATTGGGCATATGCT	1
KRS9GCG	TATGAAATTGGTAAAGTATTTAGAAATGAAGGTATAGATGCGACACATAATCCTGAATTTACTTCGTGTGAATTTTATTGGGCATATGCT	0
KRS9TAT	TATGAAATTGGTAAAGTATTTAGAAATGAAGGTATAGATTATACACATAATCCTGAATTTACTTCGTGTGAATTTTATTGGGCATATGCT	41
KRS9TAC	TATGAAATTGGTAAAGTATTTAGAAATGAAGGTATAGATTACACACATAATCCTGAATTTACTTCGTGTGAATTTTATTGGGCATATGCT	3
KRS9TAA	TATGAAATTGGTAAAGTATTTAGAAATGAAGGTATAGATTAAACACATAATCCTGAATTTACTTCGTGTGAATTTTATTGGGCATATGCT	19
KRS9TAG	TATGAAATTGGTAAAGTATTTAGAAATGAAGGTATAGATTAGACACATAATCCTGAATTTACTTCGTGTGAATTTTATTGGGCATATGCT	0
KRS9CAT	TATGAAATTGGTAAAGTATTTAGAAATGAAGGTATAGATCATACACATAATCCTGAATTTACTTCGTGTGAATTTTATTGGGCATATGCT	8
KRS9CAC	TATGAAATTGGTAAAGTATTTAGAAATGAAGGTATAGATCACACACATAATCCTGAATTTACTTCGTGTGAATTTTATTGGGCATATGCT	3
KRS9CAA	TATGAAATTGGTAAAGTATTTAGAAATGAAGGTATAGATCAAACACATAATCCTGAATTTACTTCGTGTGAATTTTATTGGGCATATGCT	4
KRS9CAG	TATGAAATTGGTAAAGTATTTAGAAATGAAGGTATAGATCAGACACATAATCCTGAATTTACTTCGTGTGAATTTTATTGGGCATATGCT	0
KRS9AAT	TATGAAATTGGTAAAGTATTTAGAAATGAAGGTATAGATAATACACATAATCCTGAATTTACTTCGTGTGAATTTTATTGGGCATATGCT	40702
KRS9AAC	TATGAAATTGGTAAAGTATTTAGAAATGAAGGTATAGATAACACACATAATCCTGAATTTACTTCGTGTGAATTTTATTGGGCATATGCT	44
KRS9AAA	TATGAAATTGGTAAAGTATTTAGAAATGAAGGTATAGATAAAACACATAATCCTGAATTTACTTCGTGTGAATTTTATTGGGCATATGCT	81
KRS9AAG	TATGAAATTGGTAAAGTATTTAGAAATGAAGGTATAGATAAGACACATAATCCTGAATTTACTTCGTGTGAATTTTATTGGGCATATGCT	5
KRS9GAT	TATGAAATTGGTAAAGTATTTAGAAATGAAGGTATAGATGATACACATAATCCTGAATTTACTTCGTGTGAATTTTATTGGGCATATGCT	53
KRS9GAC	TATGAAATTGGTAAAGTATTTAGAAATGAAGGTATAGATGACACACATAATCCTGAATTTACTTCGTGTGAATTTTATTGGGCATATGCT	2
KRS9GAA	TATGAAATTGGTAAAGTATTTAGAAATGAAGGTATAGATGAAACACATAATCCTGAATTTACTTCGTGTGAATTTTATTGGGCATATGCT	4
KRS9GAG	TATGAAATTGGTAAAGTATTTAGAAATGAAGGTATAGATGAGACACATAATCCTGAATTTACTTCGTGTGAATTTTATTGGGCATATGCT	1
KRS9TGT	TATGAAATTGGTAAAGTATTTAGAAATGAAGGTATAGATTGTACACATAATCCTGAATTTACTTCGTGTGAATTTTATTGGGCATATGCT	6
KRS9TGC	TATGAAATTGGTAAAGTATTTAGAAATGAAGGTATAGATTGCACACATAATCCTGAATTTACTTCGTGTGAATTTTATTGGGCATATGCT	1
KRS9TGA	TATGAAATTGGTAAAGTATTTAGAAATGAAGGTATAGATTGAACACATAATCCTGAATTTACTTCGTGTGAATTTTATTGGGCATATGCT	3
KRS9TGG	TATGAAATTGGTAAAGTATTTAGAAATGAAGGTATAGATTGGACACATAATCCTGAATTTACTTCGTGTGAATTTTATTGGGCATATGCT	0
KRS9CGT	TATGAAATTGGTAAAGTATTTAGAAATGAAGGTATAGATCGTACACATAATCCTGAATTTACTTCGTGTGAATTTTATTGGGCATATGCT	0
KRS9CGC	TATGAAATTGGTAAAGTATTTAGAAATGAAGGTATAGATCGCACACATAATCCTGAATTTACTTCGTGTGAATTTTATTGGGCATATGCT	0
KRS9CGA	TATGAAATTGGTAAAGTATTTAGAAATGAAGGTATAGATCGAACACATAATCCTGAATTTACTTCGTGTGAATTTTATTGGGCATATGCT	3
KRS9CGG	TATGAAATTGGTAAAGTATTTAGAAATGAAGGTATAGATCGGACACATAATCCTGAATTTACTTCGTGTGAATTTTATTGGGCATATGCT	0
KRS9AGT	TATGAAATTGGTAAAGTATTTAGAAATGAAGGTATAGATAGTACACATAATCCTGAATTTACTTCGTGTGAATTTTATTGGGCATATGCT	103
KRS9AGC	TATGAAATTGGTAAAGTATTTAGAAATGAAGGTATAGATAGCACACATAATCCTGAATTTACTTCGTGTGAATTTTATTGGGCATATGCT	0
KRS9AGA	TATGAAATTGGTAAAGTATTTAGAAATGAAGGTATAGATAGAACACATAATCCTGAATTTACTTCGTGTGAATTTTATTGGGCATATGCT	6
KRS9AGG	TATGAAATTGGTAAAGTATTTAGAAATGAAGGTATAGATAGGACACATAATCCTGAATTTACTTCGTGTGAATTTTATTGGGCATATGCT	0
KRS9GGT	TATGAAATTGGTAAAGTATTTAGAAATGAAGGTATAGATGGTACACATAATCCTGAATTTACTTCGTGTGAATTTTATTGGGCATATGCT	0
KRS9GGC	TATGAAATTGGTAAAGTATTTAGAAATGAAGGTATAGATGGCACACATAATCCTGAATTTACTTCGTGTGAATTTTATTGGGCATATGCT	0
KRS9GGA	TATGAAATTGGTAAAGTATTTAGAAATGAAGGTATAGATGGAACACATAATCCTGAATTTACTTCGTGTGAATTTTATTGGGCATATGCT	0
KRS9GGG	TATGAAATTGGTAAAGTATTTAGAAATGAAGGTATAGATGGGACACATAATCCTGAATTTACTTCGTGTGAATTTTATTGGGCATATGCT	0
KRS10TTT	TATGAAATTGGTAAAGTATTTAGAAATGAAGGTATAGATAATTTTCATAATCCTGAATTTACTTCGTGTGAATTTTATTGGGCATATGCT	11
KRS10TTC	TATGAAATTGGTAAAGTATTTAGAAATGAAGGTATAGATAATTTCCATAATCCTGAATTTACTTCGTGTGAATTTTATTGGGCATATGCT	1
KRS10TTA	TATGAAATTGGTAAAGTATTTAGAAATGAAGGTATAGATAATTTACATAATCCTGAATTTACTTCGTGTGAATTTTATTGGGCATATGCT	14
KRS10TTG	TATGAAATTGGTAAAGTATTTAGAAATGAAGGTATAGATAATTTGCATAATCCTGAATTTACTTCGTGTGAATTTTATTGGGCATATGCT	5
KRS10CTT	TATGAAATTGGTAAAGTATTTAGAAATGAAGGTATAGATAATCTTCATAATCCTGAATTTACTTCGTGTGAATTTTATTGGGCATATGCT	6
KRS10CTC	TATGAAATTGGTAAAGTATTTAGAAATGAAGGTATAGATAATCTCCATAATCCTGAATTTACTTCGTGTGAATTTTATTGGGCATATGCT	1
KRS10CTA	TATGAAATTGGTAAAGTATTTAGAAATGAAGGTATAGATAATCTACATAATCCTGAATTTACTTCGTGTGAATTTTATTGGGCATATGCT	5
KRS10CTG	TATGAAATTGGTAAAGTATTTAGAAATGAAGGTATAGATAATCTGCATAATCCTGAATTTACTTCGTGTGAATTTTATTGGGCATATGCT	1
KRS10ATT	TATGAAATTGGTAAAGTATTTAGAAATGAAGGTATAGATAATATTCATAATCCTGAATTTACTTCGTGTGAATTTTATTGGGCATATGCT	4
KRS10ATC	TATGAAATTGGTAAAGTATTTAGAAATGAAGGTATAGATAATATCCATAATCCTGAATTTACTTCGTGTGAATTTTATTGGGCATATGCT	9
KRS10ATA	TATGAAATTGGTAAAGTATTTAGAAATGAAGGTATAGATAATATACATAATCCTGAATTTACTTCGTGTGAATTTTATTGGGCATATGCT	73
KRS10ATG	TATGAAATTGGTAAAGTATTTAGAAATGAAGGTATAGATAATATGCATAATCCTGAATTTACTTCGTGTGAATTTTATTGGGCATATGCT	1
KRS10GTT	TATGAAATTGGTAAAGTATTTAGAAATGAAGGTATAGATAATGTTCATAATCCTGAATTTACTTCGTGTGAATTTTATTGGGCATATGCT	6
KRS10GTC	TATGAAATTGGTAAAGTATTTAGAAATGAAGGTATAGATAATGTCCATAATCCTGAATTTACTTCGTGTGAATTTTATTGGGCATATGCT	0
KRS10GTA	TATGAAATTGGTAAAGTATTTAGAAATGAAGGTATAGATAATGTACATAATCCTGAATTTACTTCGTGTGAATTTTATTGGGCATATGCT	3
KRS10GTG	TATGAAATTGGTAAAGTATTTAGAAATGAAGGTATAGATAATGTGCATAATCCTGAATTTACTTCGTGTGAATTTTATTGGGCATATGCT	1
KRS10TCT	TATGAAATTGGTAAAGTATTTAGAAATGAAGGTATAGATAATTCTCATAATCCTGAATTTACTTCGTGTGAATTTTATTGGGCATATGCT	6
KRS10TCC	TATGAAATTGGTAAAGTATTTAGAAATGAAGGTATAGATAATTCCCATAATCCTGAATTTACTTCGTGTGAATTTTATTGGGCATATGCT	6
KRS10TCA	TATGAAATTGGTAAAGTATTTAGAAATGAAGGTATAGATAATTCACATAATCCTGAATTTACTTCGTGTGAATTTTATTGGGCATATGCT	47
KRS10TCG	TATGAAATTGGTAAAGTATTTAGAAATGAAGGTATAGATAATTCGCATAATCCTGAATTTACTTCGTGTGAATTTTATTGGGCATATGCT	1
KRS10CCT	TATGAAATTGGTAAAGTATTTAGAAATGAAGGTATAGATAATCCTCATAATCCTGAATTTACTTCGTGTGAATTTTATTGGGCATATGCT	0
KRS10CCC	TATGAAATTGGTAAAGTATTTAGAAATGAAGGTATAGATAATCCCCATAATCCTGAATTTACTTCGTGTGAATTTTATTGGGCATATGCT	0
KRS10CCA	TATGAAATTGGTAAAGTATTTAGAAATGAAGGTATAGATAATCCACATAATCCTGAATTTACTTCGTGTGAATTTTATTGGGCATATGCT	40
KRS10CCG	TATGAAATTGGTAAAGTATTTAGAAATGAAGGTATAGATAATCCGCATAATCCTGAATTTACTTCGTGTGAATTTTATTGGGCATATGCT	0
KRS10ACT	TATGAAATTGGTAAAGTATTTAGAAATGAAGGTATAGATAATACTCATAATCCTGAATTTACTTCGTGTGAATTTTATTGGGCATATGCT	52
KRS10ACC	TATGAAATTGGTAAAGTATTTAGAAATGAAGGTATAGATAATACCCATAATCCTGAATTTACTTCGTGTGAATTTTATTGGGCATATGCT	21
KRS10ACA	TATGAAATTGGTAAAGTATTTAGAAATGAAGGTATAGATAATACACATAATCCTGAATTTACTTCGTGTGAATTTTATTGGGCATATGCT	40702
KRS10ACG	TATGAAATTGGTAAAGTATTTAGAAATGAAGGTATAGATAATACGCATAATCCTGAATTTACTTCGTGTGAATTTTATTGGGCATATGCT	103
KRS10GCT	TATGAAATTGGTAAAGTATTTAGAAATGAAGGTATAGATAATGCTCATAATCCTGAATTTACTTCGTGTGAATTTTATTGGGCATATGCT	4
KRS10GCC	TATGAAATTGGTAAAGTATTTAGAAATGAAGGTATAGATAATGCCCATAATCCTGAATTTACTTCGTGTGAATTTTATTGGGCATATGCT	0
KRS10GCA	TATGAAATTGGTAAAGTATTTAGAAATGAAGGTATAGATAATGCACATAATCCTGAATTTACTTCGTGTGAATTTTATTGGGCATATGCT	63
KRS10GCG	TATGAAATTGGTAAAGTATTTAGAAATGAAGGTATAGATAATGCGCATAATCCTGAATTTACTTCGTGTGAATTTTATTGGGCATATGCT	2
KRS10TAT	TATGAAATTGGTAAAGTATTTAGAAATGAAGGTATAGATAATTATCATAATCCTGAATTTACTTCGTGTGAATTTTATTGGGCATATGCT	10
KRS10TAC	TATGAAATTGGTAAAGTATTTAGAAATGAAGGTATAGATAATTACCATAATCCTGAATTTACTTCGTGTGAATTTTATTGGGCATATGCT	5
KRS10TAA	TATGAAATTGGTAAAGTATTTAGAAATGAAGGTATAGATAATTAACATAATCCTGAATTTACTTCGTGTGAATTTTATTGGGCATATGCT	16
KRS10TAG	TATGAAATTGGTAAAGTATTTAGAAATGAAGGTATAGATAATTAGCATAATCCTGAATTTACTTCGTGTGAATTTTATTGGGCATATGCT	1
KRS10CAT	TATGAAATTGGTAAAGTATTTAGAAATGAAGGTATAGATAATCATCATAATCCTGAATTTACTTCGTGTGAATTTTATTGGGCATATGCT	1
KRS10CAC	TATGAAATTGGTAAAGTATTTAGAAATGAAGGTATAGATAATCACCATAATCCTGAATTTACTTCGTGTGAATTTTATTGGGCATATGCT	1
KRS10CAA	TATGAAATTGGTAAAGTATTTAGAAATGAAGGTATAGATAATCAACATAATCCTGAATTTACTTCGTGTGAATTTTATTGGGCATATGCT	2
KRS10CAG	TATGAAATTGGTAAAGTATTTAGAAATGAAGGTATAGATAATCAGCATAATCCTGAATTTACTTCGTGTGAATTTTATTGGGCATATGCT	0
KRS10AAT	TATGAAATTGGTAAAGTATTTAGAAATGAAGGTATAGATAATAATCATAATCCTGAATTTACTTCGTGTGAATTTTATTGGGCATATGCT	17
KRS10AAC	TATGAAATTGGTAAAGTATTTAGAAATGAAGGTATAGATAATAACCATAATCCTGAATTTACTTCGTGTGAATTTTATTGGGCATATGCT	15
KRS10AAA	TATGAAATTGGTAAAGTATTTAGAAATGAAGGTATAGATAATAAACATAATCCTGAATTTACTTCGTGTGAATTTTATTGGGCATATGCT	42
KRS10AAG	TATGAAATTGGTAAAGTATTTAGAAATGAAGGTATAGATAATAAGCATAATCCTGAATTTACTTCGTGTGAATTTTATTGGGCATATGCT	3
KRS10GAT	TATGAAATTGGTAAAGTATTTAGAAATGAAGGTATAGATAATGATCATAATCCTGAATTTACTTCGTGTGAATTTTATTGGGCATATGCT	1
KRS10GAC	TATGAAATTGGTAAAGTATTTAGAAATGAAGGTATAGATAATGACCATAATCCTGAATTTACTTCGTGTGAATTTTATTGGGCATATGCT	0
KRS10GAA	TATGAAATTGGTAAAGTATTTAGAAATGAAGGTATAGATAATGAACATAATCCTGAATTTACTTCGTGTGAATTTTATTGGGCATATGCT	6
KRS10GAG	TATGAAATTGGTAAAGTATTTAGAAATGAAGGTATAGATAATGAGCATAATCCTGAATTTACTTCGTGTGAATTTTATTGGGCATATGCT	0
KRS10TGT	TATGAAATTGGTAAAGTATTTAGAAATGAAGGTATAGATAATTGTCATAATCCTGAATTTACTTCGTGTGAATTTTATTGGGCATATGCT	4
KRS10TGC	TATGAAATTGGTAAAGTATTTAGAAATGAAGGTATAGATAATTGCCATAATCCTGAATTTACTTCGTGTGAATTTTATTGGGCATATGCT	1
KRS10TGA	TATGAAATTGGTAAAGTATTTAGAAATGAAGGTATAGATAATTGACATAATCCTGAATTTACTTCGTGTGAATTTTATTGGGCATATGCT	1
KRS10TGG	TATGAAATTGGTAAAGTATTTAGAAATGAAGGTATAGATAATTGGCATAATCCTGAATTTACTTCGTGTGAATTTTATTGGGCATATGCT	1
KRS10CGT	TATGAAATTGGTAAAGTATTTAGAAATGAAGGTATAGATAATCGTCATAATCCTGAATTTACTTCGTGTGAATTTTATTGGGCATATGCT	4
KRS10CGC	TATGAAATTGGTAAAGTATTTAGAAATGAAGGTATAGATAATCGCCATAATCCTGAATTTACTTCGTGTGAATTTTATTGGGCATATGCT	0
KRS10CGA	TATGAAATTGGTAAAGTATTTAGAAATGAAGGTATAGATAATCGACATAATCCTGAATTTACTTCGTGTGAATTTTATTGGGCATATGCT	0
KRS10CGG	TATGAAATTGGTAAAGTATTTAGAAATGAAGGTATAGATAATCGGCATAATCCTGAATTTACTTCGTGTGAATTTTATTGGGCATATGCT	0
KRS10AGT	TATGAAATTGGTAAAGTATTTAGAAATGAAGGTATAGATAATAGTCATAATCCTGAATTTACTTCGTGTGAATTTTATTGGGCATATGCT	0
KRS10AGC	TATGAAATTGGTAAAGTATTTAGAAATGAAGGTATAGATAATAGCCATAATCCTGAATTTACTTCGTGTGAATTTTATTGGGCATATGCT	2
KRS10AGA	TATGAAATTGGTAAAGTATTTAGAAATGAAGGTATAGATAATAGACATAATCCTGAATTTACTTCGTGTGAATTTTATTGGGCATATGCT	41
KRS10AGG	TATGAAATTGGTAAAGTATTTAGAAATGAAGGTATAGATAATAGGCATAATCCTGAATTTACTTCGTGTGAATTTTATTGGGCATATGCT	0
KRS10GGT	TATGAAATTGGTAAAGTATTTAGAAATGAAGGTATAGATAATGGTCATAATCCTGAATTTACTTCGTGTGAATTTTATTGGGCATATGCT	1
KRS10GGC	TATGAAATTGGTAAAGTATTTAGAAATGAAGGTATAGATAATGGCCATAATCCTGAATTTACTTCGTGTGAATTTTATTGGGCATATGCT	2
KRS10GGA	TATGAAATTGGTAAAGTATTTAGAAATGAAGGTATAGATAATGGACATAATCCTGAATTTACTTCGTGTGAATTTTATTGGGCATATGCT	1
KRS10GGG	TATGAAATTGGTAAAGTATTTAGAAATGAAGGTATAGATAATGGGCATAATCCTGAATTTACTTCGTGTGAATTTTATTGGGCATATGCT	0
KRS11TTT	TATGAAATTGGTAAAGTATTTAGAAATGAAGGTATAGATAATACATTTAATCCTGAATTTACTTCGTGTGAATTTTATTGGGCATATGCT	910
KRS11TTC	TATGAAATTGGTAAAGTATTTAGAAATGAAGGTATAGATAATACATTCAATCCTGAATTTACTTCGTGTGAATTTTATTGGGCATATGCT	1
KRS11TTA	TATGAAATTGGTAAAGTATTTAGAAATGAAGGTATAGATAATACATTAAATCCTGAATTTACTTCGTGTGAATTTTATTGGGCATATGCT	12
KRS11TTG	TATGAAATTGGTAAAGTATTTAGAAATGAAGGTATAGATAATACATTGAATCCTGAATTTACTTCGTGTGAATTTTATTGGGCATATGCT	27
KRS11CTT	TATGAAATTGGTAAAGTATTTAGAAATGAAGGTATAGATAATACACTTAATCCTGAATTTACTTCGTGTGAATTTTATTGGGCATATGCT	16
KRS11CTC	TATGAAATTGGTAAAGTATTTAGAAATGAAGGTATAGATAATACACTCAATCCTGAATTTACTTCGTGTGAATTTTATTGGGCATATGCT	0
KRS11CTA	TATGAAATTGGTAAAGTATTTAGAAATGAAGGTATAGATAATACACTAAATCCTGAATTTACTTCGTGTGAATTTTATTGGGCATATGCT	0
KRS11CTG	TATGAAATTGGTAAAGTATTTAGAAATGAAGGTATAGATAATACACTGAATCCTGAATTTACTTCGTGTGAATTTTATTGGGCATATGCT	0
KRS11ATT	TATGAAATTGGTAAAGTATTTAGAAATGAAGGTATAGATAATACAATTAATCCTGAATTTACTTCGTGTGAATTTTATTGGGCATATGCT	102
KRS11ATC	TATGAAATTGGTAAAGTATTTAGAAATGAAGGTATAGATAATACAATCAATCCTGAATTTACTTCGTGTGAATTTTATTGGGCATATGCT	0
KRS11ATA	TATGAAATTGGTAAAGTATTTAGAAATGAAGGTATAGATAATACAATAAATCCTGAATTTACTTCGTGTGAATTTTATTGGGCATATGCT	53
KRS11ATG	TATGAAATTGGTAAAGTATTTAGAAATGAAGGTATAGATAATACAATGAATCCTGAATTTACTTCGTGTGAATTTTATTGGGCATATGCT	0
KRS11GTT	TATGAAATTGGTAAAGTATTTAGAAATGAAGGTATAGATAATACAGTTAATCCTGAATTTACTTCGTGTGAATTTTATTGGGCATATGCT	0
KRS11GTC	TATGAAATTGGTAAAGTATTTAGAAATGAAGGTATAGATAATACAGTCAATCCTGAATTTACTTCGTGTGAATTTTATTGGGCATATGCT	9
KRS11GTA	TATGAAATTGGTAAAGTATTTAGAAATGAAGGTATAGATAATACAGTAAATCCTGAATTTACTTCGTGTGAATTTTATTGGGCATATGCT	0
KRS11GTG	TATGAAATTGGTAAAGTATTTAGAAATGAAGGTATAGATAATACAGTGAATCCTGAATTTACTTCGTGTGAATTTTATTGGGCATATGCT	2
KRS11TCT	TATGAAATTGGTAAAGTATTTAGAAATGAAGGTATAGATAATACATCTAATCCTGAATTTACTTCGTGTGAATTTTATTGGGCATATGCT	1
KRS11TCC	TATGAAATTGGTAAAGTATTTAGAAATGAAGGTATAGATAATACATCCAATCCTGAATTTACTTCGTGTGAATTTTATTGGGCATATGCT	1
KRS11TCA	TATGAAATTGGTAAAGTATTTAGAAATGAAGGTATAGATAATACATCAAATCCTGAATTTACTTCGTGTGAATTTTATTGGGCATATGCT	1001
KRS11TCG	TATGAAATTGGTAAAGTATTTAGAAATGAAGGTATAGATAATACATCGAATCCTGAATTTACTTCGTGTGAATTTTATTGGGCATATGCT	12
KRS11CCT	TATGAAATTGGTAAAGTATTTAGAAATGAAGGTATAGATAATACACCTAATCCTGAATTTACTTCGTGTGAATTTTATTGGGCATATGCT	7
KRS11CCC	TATGAAATTGGTAAAGTATTTAGAAATGAAGGTATAGATAATACACCCAATCCTGAATTTACTTCGTGTGAATTTTATTGGGCATATGCT	0
KRS11CCA	TATGAAATTGGTAAAGTATTTAGAAATGAAGGTATAGATAATACACCAAATCCTGAATTTACTTCGTGTGAATTTTATTGGGCATATGCT	1
KRS11CCG	TATGAAATTGGTAAAGTATTTAGAAATGAAGGTATAGATAATACACCGAATCCTGAATTTACTTCGTGTGAATTTTATTGGGCATATGCT	0
KRS11ACT	TATGAAATTGGTAAAGTATTTAGAAATGAAGGTATAGATAATACAACTAATCCTGAATTTACTTCGTGTGAATTTTATTGGGCATATGCT	1
KRS11ACC	TATGAAATTGGTAAAGTATTTAGAAATGAAGGTATAGATAATACAACCAATCCTGAATTTACTTCGTGTGAATTTTATTGGGCATATGCT	0
KRS11ACA	TATGAAATTGGTAAAGTATTTAGAAATGAAGGTATAGATAATACAACAAATCCTGAATTTACTTCGTGTGAATTTTATTGGGCATATGCT	13
KRS11ACG	TATGAAATTGGTAAAGTATTTAGAAATGAAGGTATAGATAATACAACGAATCCTGAATTTACTTCGTGTGAATTTTATTGGGCATATGCT	0
KRS11GCT	TATGAAATTGGTAAAGTATTTAGAAATGAAGGTATAGATAATACAGCTAATCCTGAATTTACTTCGTGTGAATTTTATTGGGCATATGCT	0
KRS11GCC	TATGAAATTGGTAAAGTATTTAGAAATGAAGGTATAGATAATACAGCCAATCCTGAATTTACTTCGTGTGAATTTTATTGGGCATATGCT	0
KRS11GCA	TATGAAATTGGTAAAGTATTTAGAAATGAAGGTATAGATAATACAGCAAATCCTGAATTTACTTCGTGTGAATTTTATTGGGCATATGCT	1
KRS11GCG	TATGAAATTGGTAAAGTATTTAGAAATGAAGGTATAGATAATACAGCGAATCCTGAATTTACTTCGTGTGAATTTTATTGGGCATATGCT	0
KRS11TAT	TATGAAATTGGTAAAGTATTTAGAAATGAAGGTATAGATAATACATATAATCCTGAATTTACTTCGTGTGAATTTTATTGGGCATATGCT	48
KRS11TAC	TATGAAATTGGTAAAGTATTTAGAAATGAAGGTATAGATAATACATACAATCCTGAATTTACTTCGTGTGAATTTTATTGGGCATATGCT	112
KRS11TAA	TATGAAATTGGTAAAGTATTTAGAAATGAAGGTATAGATAATACATAAAATCCTGAATTTACTTCGTGTGAATTTTATTGGGCATATGCT	773
KRS11TAG	TATGAAATTGGTAAAGTATTTAGAAATGAAGGTATAGATAATACATAGAATCCTGAATTTACTTCGTGTGAATTTTATTGGGCATATGCT	97031
KRS11CAT	TATGAAATTGGTAAAGTATTTAGAAATGAAGGTATAGATAATACACATAATCCTGAATTTACTTCGTGTGAATTTTATTGGGCATATGCT	40702
KRS11CAC	TATGAAATTGGTAAAGTATTTAGAAATGAAGGTATAGATAATACACACAATCCTGAATTTACTTCGTGTGAATTTTATTGGGCATATGCT	38
KRS11CAA	TATGAAATTGGTAAAGTATTTAGAAATGAAGGTATAGATAATACACAAAATCCTGAATTTACTTCGTGTGAATTTTATTGGGCATATGCT	101
KRS11CAG	TATGAAATTGGTAAAGTATTTAGAAATGAAGGTATAGATAATACACAGAATCCTGAATTTACTTCGTGTGAATTTTATTGGGCATATGCT	199
KRS11AAT	TATGAAATTGGTAAAGTATTTAGAAATGAAGGTATAGATAATACAAATAATCCTGAATTTACTTCGTGTGAATTTTATTGGGCATATGCT	185
KRS11AAC	TATGAAATTGGTAAAGTATTTAGAAATGAAGGTATAGATAATACAAACAATCCTGAATTTACTTCGTGTGAATTTTATTGGGCATATGCT	139
KRS11AAA	TATGAAATTGGTAAAGTATTTAGAAATGAAGGTATAGATAATACAAAAAATCCTGAATTTACTTCGTGTGAATTTTATTGGGCATATGCT	12955
KRS11AAG	TATGAAATTGGTAAAGTATTTAGAAATGAAGGTATAGATAATACAAAGAATCCTGAATTTACTTCGTGTGAATTTTATTGGGCATATGCT	67
KRS11GAT	TATGAAATTGGTAAAGTATTTAGAAATGAAGGTATAGATAATACAGATAATCCTGAATTTACTTCGTGTGAATTTTATTGGGCATATGCT	89
KRS11GAC	TATGAAATTGGTAAAGTATTTAGAAATGAAGGTATAGATAATACAGACAATCCTGAATTTACTTCGTGTGAATTTTATTGGGCATATGCT	3
KRS11GAA	TATGAAATTGGTAAAGTATTTAGAAATGAAGGTATAGATAATACAGAAAATCCTGAATTTACTTCGTGTGAATTTTATTGGGCATATGCT	300
KRS11GAG	TATGAAATTGGTAAAGTATTTAGAAATGAAGGTATAGATAATACAGAGAATCCTGAATTTACTTCGTGTGAATTTTATTGGGCATATGCT	4
KRS11TGT	TATGAAATTGGTAAAGTATTTAGAAATGAAGGTATAGATAATACATGTAATCCTGAATTTACTTCGTGTGAATTTTATTGGGCATATGCT	1
KRS11TGC	TATGAAATTGGTAAAGTATTTAGAAATGAAGGTATAGATAATACATGCAATCCTGAATTTACTTCGTGTGAATTTTATTGGGCATATGCT	37
KRS11TGA	TATGAAATTGGTAAAGTATTTAGAAATGAAGGTATAGATAATACATGAAATCCTGAATTTACTTCGTGTGAATTTTATTGGGCATATGCT	47
KRS11TGG	TATGAAATTGGTAAAGTATTTAGAAATGAAGGTATAGATAATACATGGAATCCTGAATTTACTTCGTGTGAATTTTATTGGGCATATGCT	101
KRS11CGT	TATGAAATTGGTAAAGTATTTAGAAATGAAGGTATAGATAATACACGTAATCCTGAATTTACTTCGTGTGAATTTTATTGGGCATATGCT	75
KRS11CGC	TATGAAATTGGTAAAGTATTTAGAAATGAAGGTATAGATAATACACGCAATCCTGAATTTACTTCGTGTGAATTTTATTGGGCATATGCT	0
KRS11CGA	TATGAAATTGGTAAAGTATTTAGAAATGAAGGTATAGATAATACACGAAATCCTGAATTTACTTCGTGTGAATTTTATTGGGCATATGCT	1
KRS11CGG	TATGAAATTGGTAAAGTATTTAGAAATGAAGGTATAGATAATACACGGAATCCTGAATTTACTTCGTGTGAATTTTATTGGGCATATGCT	1
KRS11AGT	TATGAAATTGGTAAAGTATTTAGAAATGAAGGTATAGATAATACAAGTAATCCTGAATTTACTTCGTGTGAATTTTATTGGGCATATGCT	0
KRS11AGC	TATGAAATTGGTAAAGTATTTAGAAATGAAGGTATAGATAATACAAGCAATCCTGAATTTACTTCGTGTGAATTTTATTGGGCATATGCT	0
KRS11AGA	TATGAAATTGGTAAAGTATTTAGAAATGAAGGTATAGATAATACAAGAAATCCTGAATTTACTTCGTGTGAATTTTATTGGGCATATGCT	18
KRS11AGG	TATGAAATTGGTAAAGTATTTAGAAATGAAGGTATAGATAATACAAGGAATCCTGAATTTACTTCGTGTGAATTTTATTGGGCATATGCT	0
KRS11GGT	TATGAAATTGGTAAAGTATTTAGAAATGAAGGTATAGATAATACAGGTAATCCTGAATTTACTTCGTGTGAATTTTATTGGGCATATGCT	0
KRS11GGC	TATGAAATTGGTAAAGTATTTAGAAATGAAGGTATAGATAATACAGGCAATCCTGAATTTACTTCGTGTGAATTTTATTGGGCATATGCT	0
KRS11GGA	TATGAAATTGGTAAAGTATTTAGAAATGAAGGTATAGATAATACAGGAAATCCTGAATTTACTTCGTGTGAATTTTATTGGGCATATGCT	0
KRS11GGG	TATGAAATTGGTAAAGTATTTAGAAATGAAGGTATAGATAATACAGGGAATCCTGAATTTACTTCGTGTGAATTTTATTGGGCATATGCT	0
KRS12TTT	TATGAAATTGGTAAAGTATTTAGAAATGAAGGTATAGATAATACACATTTTCCTGAATTTACTTCGTGTGAATTTTATTGGGCATATGCT	1414
KRS12TTC	TATGAAATTGGTAAAGTATTTAGAAATGAAGGTATAGATAATACACATTTCCCTGAATTTACTTCGTGTGAATTTTATTGGGCATATGCT	1124
KRS12TTA	TATGAAATTGGTAAAGTATTTAGAAATGAAGGTATAGATAATACACATTTACCTGAATTTACTTCGTGTGAATTTTATTGGGCATATGCT	28113
KRS12TTG	TATGAAATTGGTAAAGTATTTAGAAATGAAGGTATAGATAATACACATTTGCCTGAATTTACTTCGTGTGAATTTTATTGGGCATATGCT	126
KRS12CTT	TATGAAATTGGTAAAGTATTTAGAAATGAAGGTATAGATAATACACATCTTCCTGAATTTACTTCGTGTGAATTTTATTGGGCATATGCT	11
KRS12CTC	TATGAAATTGGTAAAGTATTTAGAAATGAAGGTATAGATAATACACATCTCCCTGAATTTACTTCGTGTGAATTTTATTGGGCATATGCT	6
KRS12CTA	TATGAAATTGGTAAAGTATTTAGAAATGAAGGTATAGATAATACACATCTACCTGAATTTACTTCGTGTGAATTTTATTGGGCATATGCT	2660
KRS12CTG	TATGAAATTGGTAAAGTATTTAGAAATGAAGGTATAGATAATACACATCTGCCTGAATTTACTTCGTGTGAATTTTATTGGGCATATGCT	97
KRS12ATT	TATGAAATTGGTAAAGTATTTAGAAATGAAGGTATAGATAATACACATATTCCTGAATTTACTTCGTGTGAATTTTATTGGGCATATGCT	31
KRS12ATC	TATGAAATTGGTAAAGTATTTAGAAATGAAGGTATAGATAATACACATATCCCTGAATTTACTTCGTGTGAATTTTATTGGGCATATGCT	57
KRS12ATA	TATGAAATTGGTAAAGTATTTAGAAATGAAGGTATAGATAATACACATATACCTGAATTTACTTCGTGTGAATTTTATTGGGCATATGCT	147
KRS12ATG	TATGAAATTGGTAAAGTATTTAGAAATGAAGGTATAGATAATACACATATGCCTGAATTTACTTCGTGTGAATTTTATTGGGCATATGCT	36680
KRS12GTT	TATGAAATTGGTAAAGTATTTAGAAATGAAGGTATAGATAATACACATGTTCCTGAATTTACTTCGTGTGAATTTTATTGGGCATATGCT	1525
KRS12GTC	TATGAAATTGGTAAAGTATTTAGAAATGAAGGTATAGATAATACACATGTCCCTGAATTTACTTCGTGTGAATTTTATTGGGCATATGCT	574
KRS12GTA	TATGAAATTGGTAAAGTATTTAGAAATGAAGGTATAGATAATACACATGTACCTGAATTTACTTCGTGTGAATTTTATTGGGCATATGCT	1183
KRS12GTG	TATGAAATTGGTAAAGTATTTAGAAATGAAGGTATAGATAATACACATGTGCCTGAATTTACTTCGTGTGAATTTTATTGGGCATATGCT	54
KRS12TCT	TATGAAATTGGTAAAGTATTTAGAAATGAAGGTATAGATAATACACATTCTCCTGAATTTACTTCGTGTGAATTTTATTGGGCATATGCT	1711
KRS12TCC	TATGAAATTGGTAAAGTATTTAGAAATGAAGGTATAGATAATACACATTCCCCTGAATTTACTTCGTGTGAATTTTATTGGGCATATGCT	5
KRS12TCA	TATGAAATTGGTAAAGTATTTAGAAATGAAGGTATAGATAATACACATTCACCTGAATTTACTTCGTGTGAATTTTATTGGGCATATGCT	35
KRS12TCG	TATGAAATTGGTAAAGTATTTAGAAATGAAGGTATAGATAATACACATTCGCCTGAATTTACTTCGTGTGAATTTTATTGGGCATATGCT	9
KRS12CCT	TATGAAATTGGTAAAGTATTTAGAAATGAAGGTATAGATAATACACATCCTCCTGAATTTACTTCGTGTGAATTTTATTGGGCATATGCT	9
KRS12CCC	TATGAAATTGGTAAAGTATTTAGAAATGAAGGTATAGATAATACACATCCCCCTGAATTTACTTCGTGTGAATTTTATTGGGCATATGCT	1
KRS12CCA	TATGAAATTGGTAAAGTATTTAGAAATGAAGGTATAGATAATACACATCCACCTGAATTTACTTCGTGTGAATTTTATTGGGCATATGCT	5
KRS12CCG	TATGAAATTGGTAAAGTATTTAGAAATGAAGGTATAGATAATACACATCCGCCTGAATTTACTTCGTGTGAATTTTATTGGGCATATGCT	1
KRS12ACT	TATGAAATTGGTAAAGTATTTAGAAATGAAGGTATAGATAATACACATACTCCTGAATTTACTTCGTGTGAATTTTATTGGGCATATGCT	20
KRS12ACC	TATGAAATTGGTAAAGTATTTAGAAATGAAGGTATAGATAATACACATACCCCTGAATTTACTTCGTGTGAATTTTATTGGGCATATGCT	2
KRS12ACA	TATGAAATTGGTAAAGTATTTAGAAATGAAGGTATAGATAATACACATACACCTGAATTTACTTCGTGTGAATTTTATTGGGCATATGCT	756
KRS12ACG	TATGAAATTGGTAAAGTATTTAGAAATGAAGGTATAGATAATACACATACGCCTGAATTTACTTCGTGTGAATTTTATTGGGCATATGCT	281
KRS12GCT	TATGAAATTGGTAAAGTATTTAGAAATGAAGGTATAGATAATACACATGCTCCTGAATTTACTTCGTGTGAATTTTATTGGGCATATGCT	52
KRS12GCC	TATGAAATTGGTAAAGTATTTAGAAATGAAGGTATAGATAATACACATGCCCCTGAATTTACTTCGTGTGAATTTTATTGGGCATATGCT	4
KRS12GCA	TATGAAATTGGTAAAGTATTTAGAAATGAAGGTATAGATAATACACATGCACCTGAATTTACTTCGTGTGAATTTTATTGGGCATATGCT	33
KRS12GCG	TATGAAATTGGTAAAGTATTTAGAAATGAAGGTATAGATAATACACATGCGCCTGAATTTACTTCGTGTGAATTTTATTGGGCATATGCT	0
KRS12TAT	TATGAAATTGGTAAAGTATTTAGAAATGAAGGTATAGATAATACACATTATCCTGAATTTACTTCGTGTGAATTTTATTGGGCATATGCT	653
KRS12TAC	TATGAAATTGGTAAAGTATTTAGAAATGAAGGTATAGATAATACACATTACCCTGAATTTACTTCGTGTGAATTTTATTGGGCATATGCT	5
KRS12TAA	TATGAAATTGGTAAAGTATTTAGAAATGAAGGTATAGATAATACACATTAACCTGAATTTACTTCGTGTGAATTTTATTGGGCATATGCT	983
KRS12TAG	TATGAAATTGGTAAAGTATTTAGAAATGAAGGTATAGATAATACACATTAGCCTGAATTTACTTCGTGTGAATTTTATTGGGCATATGCT	2
KRS12CAT	TATGAAATTGGTAAAGTATTTAGAAATGAAGGTATAGATAATACACATCATCCTGAATTTACTTCGTGTGAATTTTATTGGGCATATGCT	26
KRS12CAC	TATGAAATTGGTAAAGTATTTAGAAATGAAGGTATAGATAATACACATCACCCTGAATTTACTTCGTGTGAATTTTATTGGGCATATGCT	3
KRS12CAA	TATGAAATTGGTAAAGTATTTAGAAATGAAGGTATAGATAATACACATCAACCTGAATTTACTTCGTGTGAATTTTATTGGGCATATGCT	592
KRS12CAG	TATGAAATTGGTAAAGTATTTAGAAATGAAGGTATAGATAATACACATCAGCCTGAATTTACTTCGTGTGAATTTTATTGGGCATATGCT	4
KRS12AAT	TATGAAATTGGTAAAGTATTTAGAAATGAAGGTATAGATAATACACATAATCCTGAATTTACTTCGTGTGAATTTTATTGGGCATATGCT	40702
KRS12AAC	TATGAAATTGGTAAAGTATTTAGAAATGAAGGTATAGATAATACACATAACCCTGAATTTACTTCGTGTGAATTTTATTGGGCATATGCT	942
KRS12AAA	TATGAAATTGGTAAAGTATTTAGAAATGAAGGTATAGATAATACACATAAACCTGAATTTACTTCGTGTGAATTTTATTGGGCATATGCT	134608
KRS12AAG	TATGAAATTGGTAAAGTATTTAGAAATGAAGGTATAGATAATACACATAAGCCTGAATTTACTTCGTGTGAATTTTATTGGGCATATGCT	345
KRS12GAT	TATGAAATTGGTAAAGTATTTAGAAATGAAGGTATAGATAATACACATGATCCTGAATTTACTTCGTGTGAATTTTATTGGGCATATGCT	448
KRS12GAC	TATGAAATTGGTAAAGTATTTAGAAATGAAGGTATAGATAATACACATGACCCTGAATTTACTTCGTGTGAATTTTATTGGGCATATGCT	150
KRS12GAA	TATGAAATTGGTAAAGTATTTAGAAATGAAGGTATAGATAATACACATGAACCTGAATTTACTTCGTGTGAATTTTATTGGGCATATGCT	170585
KRS12GAG	TATGAAATTGGTAAAGTATTTAGAAATGAAGGTATAGATAATACACATGAGCCTGAATTTACTTCGTGTGAATTTTATTGGGCATATGCT	477
KRS12TGT	TATGAAATTGGTAAAGTATTTAGAAATGAAGGTATAGATAATACACATTGTCCTGAATTTACTTCGTGTGAATTTTATTGGGCATATGCT	11
KRS12TGC	TATGAAATTGGTAAAGTATTTAGAAATGAAGGTATAGATAATACACATTGCCCTGAATTTACTTCGTGTGAATTTTATTGGGCATATGCT	1
KRS12TGA	TATGAAATTGGTAAAGTATTTAGAAATGAAGGTATAGATAATACACATTGACCTGAATTTACTTCGTGTGAATTTTATTGGGCATATGCT	2
KRS12TGG	TATGAAATTGGTAAAGTATTTAGAAATGAAGGTATAGATAATACACATTGGCCTGAATTTACTTCGTGTGAATTTTATTGGGCATATGCT	0
KRS12CGT	TATGAAATTGGTAAAGTATTTAGAAATGAAGGTATAGATAATACACATCGTCCTGAATTTACTTCGTGTGAATTTTATTGGGCATATGCT	45
KRS12CGC	TATGAAATTGGTAAAGTATTTAGAAATGAAGGTATAGATAATACACATCGCCCTGAATTTACTTCGTGTGAATTTTATTGGGCATATGCT	0
KRS12CGA	TATGAAATTGGTAAAGTATTTAGAAATGAAGGTATAGATAATACACATCGACCTGAATTTACTTCGTGTGAATTTTATTGGGCATATGCT	2
KRS12CGG	TATGAAATTGGTAAAGTATTTAGAAATGAAGGTATAGATAATACACATCGGCCTGAATTTACTTCGTGTGAATTTTATTGGGCATATGCT	0
KRS12AGT	TATGAAATTGGTAAAGTATTTAGAAATGAAGGTATAGATAATACACATAGTCCTGAATTTACTTCGTGTGAATTTTATTGGGCATATGCT	201
KRS12AGC	TATGAAATTGGTAAAGTATTTAGAAATGAAGGTATAGATAATACACATAGCCCTGAATTTACTTCGTGTGAATTTTATTGGGCATATGCT	1
KRS12AGA	TATGAAATTGGTAAAGTATTTAGAAATGAAGGTATAGATAATACACATAGACCTGAATTTACTTCGTGTGAATTTTATTGGGCATATGCT	294
KRS12AGG	TATGAAATTGGTAAAGTATTTAGAAATGAAGGTATAGATAATACACATAGGCCTGAATTTACTTCGTGTGAATTTTATTGGGCATATGCT	7
KRS12GGT	TATGAAATTGGTAAAGTATTTAGAAATGAAGGTATAGATAATACACATGGTCCTGAATTTACTTCGTGTGAATTTTATTGGGCATATGCT	41144
KRS12GGC	TATGAAATTGGTAAAGTATTTAGAAATGAAGGTATAGATAATACACATGGCCCTGAATTTACTTCGTGTGAATTTTATTGGGCATATGCT	143
KRS12GGA	TATGAAATTGGTAAAGTATTTAGAAATGAAGGTATAGATAATACACATGGACCTGAATTTACTTCGTGTGAATTTTATTGGGCATATGCT	525
KRS12GGG	TATGAAATTGGTAAAGTATTTAGAAATGAAGGTATAGATAATACACATGGGCCTGAATTTACTTCGTGTGAATTTTATTGGGCATATGCT	42
KRS13TTT	TATGAAATTGGTAAAGTATTTAGAAATGAAGGTATAGATAATACACATAATTTTGAATTTACTTCGTGTGAATTTTATTGGGCATATGCT	52
KRS13TTC	TATGAAATTGGTAAAGTATTTAGAAATGAAGGTATAGATAATACACATAATTTCGAATTTACTTCGTGTGAATTTTATTGGGCATATGCT	2087
KRS13TTA	TATGAAATTGGTAAAGTATTTAGAAATGAAGGTATAGATAATACACATAATTTAGAATTTACTTCGTGTGAATTTTATTGGGCATATGCT	204
KRS13TTG	TATGAAATTGGTAAAGTATTTAGAAATGAAGGTATAGATAATACACATAATTTGGAATTTACTTCGTGTGAATTTTATTGGGCATATGCT	88
KRS13CTT	TATGAAATTGGTAAAGTATTTAGAAATGAAGGTATAGATAATACACATAATCTTGAATTTACTTCGTGTGAATTTTATTGGGCATATGCT	60
KRS13CTC	TATGAAATTGGTAAAGTATTTAGAAATGAAGGTATAGATAATACACATAATCTCGAATTTACTTCGTGTGAATTTTATTGGGCATATGCT	8
KRS13CTA	TATGAAATTGGTAAAGTATTTAGAAATGAAGGTATAGATAATACACATAATCTAGAATTTACTTCGTGTGAATTTTATTGGGCATATGCT	984
KRS13CTG	TATGAAATTGGTAAAGTATTTAGAAATGAAGGTATAGATAATACACATAATCTGGAATTTACTTCGTGTGAATTTTATTGGGCATATGCT	2
KRS13ATT	TATGAAATTGGTAAAGTATTTAGAAATGAAGGTATAGATAATACACATAATATTGAATTTACTTCGTGTGAATTTTATTGGGCATATGCT	52
KRS13ATC	TATGAAATTGGTAAAGTATTTAGAAATGAAGGTATAGATAATACACATAATATCGAATTTACTTCGTGTGAATTTTATTGGGCATATGCT	12
KRS13ATA	TATGAAATTGGTAAAGTATTTAGAAATGAAGGTATAGATAATACACATAATATAGAATTTACTTCGTGTGAATTTTATTGGGCATATGCT	1133
KRS13ATG	TATGAAATTGGTAAAGTATTTAGAAATGAAGGTATAGATAATACACATAATATGGAATTTACTTCGTGTGAATTTTATTGGGCATATGCT	23
KRS13GTT	TATGAAATTGGTAAAGTATTTAGAAATGAAGGTATAGATAATACACATAATGTTGAATTTACTTCGTGTGAATTTTATTGGGCATATGCT	418
KRS13GTC	TATGAAATTGGTAAAGTATTTAGAAATGAAGGTATAGATAATACACATAATGTCGAATTTACTTCGTGTGAATTTTATTGGGCATATGCT	1
KRS13GTA	TATGAAATTGGTAAAGTATTTAGAAATGAAGGTATAGATAATACACATAATGTAGAATTTACTTCGTGTGAATTTTATTGGGCATATGCT	75
KRS13GTG	TATGAAATTGGTAAAGTATTTAGAAATGAAGGTATAGATAATACACATAATGTGGAATTTACTTCGTGTGAATTTTATTGGGCATATGCT	3
KRS13TCT	TATGAAATTGGTAAAGTATTTAGAAATGAAGGTATAGATAATACACATAATTCTGAATTTACTTCGTGTGAATTTTATTGGGCATATGCT	77
KRS13TCC	TATGAAATTGGTAAAGTATTTAGAAATGAAGGTATAGATAATACACATAATTCCGAATTTACTTCGTGTGAATTTTATTGGGCATATGCT	7
KRS13TCA	TATGAAATTGGTAAAGTATTTAGAAATGAAGGTATAGATAATACACATAATTCAGAATTTACTTCGTGTGAATTTTATTGGGCATATGCT	4
KRS13TCG	TATGAAATTGGTAAAGTATTTAGAAATGAAGGTATAGATAATACACATAATTCGGAATTTACTTCGTGTGAATTTTATTGGGCATATGCT	0
KRS13CCT	TATGAAATTGGTAAAGTATTTAGAAATGAAGGTATAGATAATACACATAATCCTGAATTTACTTCGTGTGAATTTTATTGGGCATATGCT	40702
KRS13CCC	TATGAAATTGGTAAAGTATTTAGAAATGAAGGTATAGATAATACACATAATCCCGAATTTACTTCGTGTGAATTTTATTGGGCATATGCT	75
KRS13CCA	TATGAAATTGGTAAAGTATTTAGAAATGAAGGTATAGATAATACACATAATCCAGAATTTACTTCGTGTGAATTTTATTGGGCATATGCT	19
KRS13CCG	TATGAAATTGGTAAAGTATTTAGAAATGAAGGTATAGATAATACACATAATCCGGAATTTACTTCGTGTGAATTTTATTGGGCATATGCT	3
KRS13ACT	TATGAAATTGGTAAAGTATTTAGAAATGAAGGTATAGATAATACACATAATACTGAATTTACTTCGTGTGAATTTTATTGGGCATATGCT	567
KRS13ACC	TATGAAATTGGTAAAGTATTTAGAAATGAAGGTATAGATAATACACATAATACCGAATTTACTTCGTGTGAATTTTATTGGGCATATGCT	0
KRS13ACA	TATGAAATTGGTAAAGTATTTAGAAATGAAGGTATAGATAATACACATAATACAGAATTTACTTCGTGTGAATTTTATTGGGCATATGCT	1334
KRS13ACG	TATGAAATTGGTAAAGTATTTAGAAATGAAGGTATAGATAATACACATAATACGGAATTTACTTCGTGTGAATTTTATTGGGCATATGCT	6
KRS13GCT	TATGAAATTGGTAAAGTATTTAGAAATGAAGGTATAGATAATACACATAATGCTGAATTTACTTCGTGTGAATTTTATTGGGCATATGCT	110
KRS13GCC	TATGAAATTGGTAAAGTATTTAGAAATGAAGGTATAGATAATACACATAATGCCGAATTTACTTCGTGTGAATTTTATTGGGCATATGCT	0
KRS13GCA	TATGAAATTGGTAAAGTATTTAGAAATGAAGGTATAGATAATACACATAATGCAGAATTTACTTCGTGTGAATTTTATTGGGCATATGCT	6
KRS13GCG	TATGAAATTGGTAAAGTATTTAGAAATGAAGGTATAGATAATACACATAATGCGGAATTTACTTCGTGTGAATTTTATTGGGCATATGCT	0
KRS13TAT	TATGAAATTGGTAAAGTATTTAGAAATGAAGGTATAGATAATACACATAATTATGAATTTACTTCGTGTGAATTTTATTGGGCATATGCT	37
KRS13TAC	TATGAAATTGGTAAAGTATTTAGAAATGAAGGTATAGATAATACACATAATTACGAATTTACTTCGTGTGAATTTTATTGGGCATATGCT	3
KRS13TAA	TATGAAATTGGTAAAGTATTTAGAAATGAAGGTATAGATAATACACATAATTAAGAATTTACTTCGTGTGAATTTTATTGGGCATATGCT	102
KRS13TAG	TATGAAATTGGTAAAGTATTTAGAAATGAAGGTATAGATAATACACATAATTAGGAATTTACTTCGTGTGAATTTTATTGGGCATATGCT	0
KRS13CAT	TATGAAATTGGTAAAGTATTTAGAAATGAAGGTATAGATAATACACATAATCATGAATTTACTTCGTGTGAATTTTATTGGGCATATGCT	235
KRS13CAC	TATGAAATTGGTAAAGTATTTAGAAATGAAGGTATAGATAATACACATAATCACGAATTTACTTCGTGTGAATTTTATTGGGCATATGCT	12
KRS13CAA	TATGAAATTGGTAAAGTATTTAGAAATGAAGGTATAGATAATACACATAATCAAGAATTTACTTCGTGTGAATTTTATTGGGCATATGCT	2
KRS13CAG	TATGAAATTGGTAAAGTATTTAGAAATGAAGGTATAGATAATACACATAATCAGGAATTTACTTCGTGTGAATTTTATTGGGCATATGCT	0
KRS13AAT	TATGAAATTGGTAAAGTATTTAGAAATGAAGGTATAGATAATACACATAATAATGAATTTACTTCGTGTGAATTTTATTGGGCATATGCT	401
KRS13AAC	TATGAAATTGGTAAAGTATTTAGAAATGAAGGTATAGATAATACACATAATAACGAATTTACTTCGTGTGAATTTTATTGGGCATATGCT	25
KRS13AAA	TATGAAATTGGTAAAGTATTTAGAAATGAAGGTATAGATAATACACATAATAAAGAATTTACTTCGTGTGAATTTTATTGGGCATATGCT	14
KRS13AAG	TATGAAATTGGTAAAGTATTTAGAAATGAAGGTATAGATAATACACATAATAAGGAATTTACTTCGTGTGAATTTTATTGGGCATATGCT	0
KRS13GAT	TATGAAATTGGTAAAGTATTTAGAAATGAAGGTATAGATAATACACATAATGATGAATTTACTTCGTGTGAATTTTATTGGGCATATGCT	3
KRS13GAC	TATGAAATTGGTAAAGTATTTAGAAATGAAGGTATAGATAATACACATAATGACGAATTTACTTCGTGTGAATTTTATTGGGCATATGCT	0
KRS13GAA	TATGAAATTGGTAAAGTATTTAGAAATGAAGGTATAGATAATACACATAATGAAGAATTTACTTCGTGTGAATTTTATTGGGCATATGCT	6
KRS13GAG	TATGAAATTGGTAAAGTATTTAGAAATGAAGGTATAGATAATACACATAATGAGGAATTTACTTCGTGTGAATTTTATTGGGCATATGCT	0
KRS13TGT	TATGAAATTGGTAAAGTATTTAGAAATGAAGGTATAGATAATACACATAATTGTGAATTTACTTCGTGTGAATTTTATTGGGCATATGCT	1
KRS13TGC	TATGAAATTGGTAAAGTATTTAGAAATGAAGGTATAGATAATACACATAATTGCGAATTTACTTCGTGTGAATTTTATTGGGCATATGCT	1
KRS13TGA	TATGAAATTGGTAAAGTATTTAGAAATGAAGGTATAGATAATACACATAATTGAGAATTTACTTCGTGTGAATTTTATTGGGCATATGCT	2
KRS13TGG	TATGAAATTGGTAAAGTATTTAGAAATGAAGGTATAGATAATACACATAATTGGGAATTTACTTCGTGTGAATTTTATTGGGCATATGCT	0
KRS13CGT	TATGAAATTGGTAAAGTATTTAGAAATGAAGGTATAGATAATACACATAATCGTGAATTTACTTCGTGTGAATTTTATTGGGCATATGCT	40
KRS13CGC	TATGAAATTGGTAAAGTATTTAGAAATGAAGGTATAGATAATACACATAATCGCGAATTTACTTCGTGTGAATTTTATTGGGCATATGCT	0
KRS13CGA	TATGAAATTGGTAAAGTATTTAGAAATGAAGGTATAGATAATACACATAATCGAGAATTTACTTCGTGTGAATTTTATTGGGCATATGCT	0
KRS13CGG	TATGAAATTGGTAAAGTATTTAGAAATGAAGGTATAGATAATACACATAATCGGGAATTTACTTCGTGTGAATTTTATTGGGCATATGCT	1
KRS13AGT	TATGAAATTGGTAAAGTATTTAGAAATGAAGGTATAGATAATACACATAATAGTGAATTTACTTCGTGTGAATTTTATTGGGCATATGCT	19
KRS13AGC	TATGAAATTGGTAAAGTATTTAGAAATGAAGGTATAGATAATACACATAATAGCGAATTTACTTCGTGTGAATTTTATTGGGCATATGCT	1
KRS13AGA	TATGAAATTGGTAAAGTATTTAGAAATGAAGGTATAGATAATACACATAATAGAGAATTTACTTCGTGTGAATTTTATTGGGCATATGCT	0
KRS13AGG	TATGAAATTGGTAAAGTATTTAGAAATGAAGGTATAGATAATACACATAATAGGGAATTTACTTCGTGTGAATTTTATTGGGCATATGCT	0
KRS13GGT	TATGAAATTGGTAAAGTATTTAGAAATGAAGGTATAGATAATACACATAATGGTGAATTTACTTCGTGTGAATTTTATTGGGCATATGCT	2
KRS13GGC	TATGAAATTGGTAAAGTATTTAGAAATGAAGGTATAGATAATACACATAATGGCGAATTTACTTCGTGTGAATTTTATTGGGCATATGCT	0
KRS13GGA	TATGAAATTGGTAAAGTATTTAGAAATGAAGGTATAGATAATACACATAATGGAGAATTTACTTCGTGTGAATTTTATTGGGCATATGCT	0
KRS13GGG	TATGAAATTGGTAAAGTATTTAGAAATGAAGGTATAGATAATACACATAATGGGGAATTTACTTCGTGTGAATTTTATTGGGCATATGCT	0
KRS14TTT	TATGAAATTGGTAAAGTATTTAGAAATGAAGGTATAGATAATACACATAATCCTTTTTTTACTTCGTGTGAATTTTATTGGGCATATGCT	2
KRS14TTC	TATGAAATTGGTAAAGTATTTAGAAATGAAGGTATAGATAATACACATAATCCTTTCTTTACTTCGTGTGAATTTTATTGGGCATATGCT	0
KRS14TTA	TATGAAATTGGTAAAGTATTTAGAAATGAAGGTATAGATAATACACATAATCCTTTATTTACTTCGTGTGAATTTTATTGGGCATATGCT	0
KRS14TTG	TATGAAATTGGTAAAGTATTTAGAAATGAAGGTATAGATAATACACATAATCCTTTGTTTACTTCGTGTGAATTTTATTGGGCATATGCT	4
KRS14CTT	TATGAAATTGGTAAAGTATTTAGAAATGAAGGTATAGATAATACACATAATCCTCTTTTTACTTCGTGTGAATTTTATTGGGCATATGCT	1
KRS14CTC	TATGAAATTGGTAAAGTATTTAGAAATGAAGGTATAGATAATACACATAATCCTCTCTTTACTTCGTGTGAATTTTATTGGGCATATGCT	0
KRS14CTA	TATGAAATTGGTAAAGTATTTAGAAATGAAGGTATAGATAATACACATAATCCTCTATTTACTTCGTGTGAATTTTATTGGGCATATGCT	0
KRS14CTG	TATGAAATTGGTAAAGTATTTAGAAATGAAGGTATAGATAATACACATAATCCTCTGTTTACTTCGTGTGAATTTTATTGGGCATATGCT	2
KRS14ATT	TATGAAATTGGTAAAGTATTTAGAAATGAAGGTATAGATAATACACATAATCCTATTTTTACTTCGTGTGAATTTTATTGGGCATATGCT	1
KRS14ATC	TATGAAATTGGTAAAGTATTTAGAAATGAAGGTATAGATAATACACATAATCCTATCTTTACTTCGTGTGAATTTTATTGGGCATATGCT	0
KRS14ATA	TATGAAATTGGTAAAGTATTTAGAAATGAAGGTATAGATAATACACATAATCCTATATTTACTTCGTGTGAATTTTATTGGGCATATGCT	8
KRS14ATG	TATGAAATTGGTAAAGTATTTAGAAATGAAGGTATAGATAATACACATAATCCTATGTTTACTTCGTGTGAATTTTATTGGGCATATGCT	45
KRS14GTT	TATGAAATTGGTAAAGTATTTAGAAATGAAGGTATAGATAATACACATAATCCTGTTTTTACTTCGTGTGAATTTTATTGGGCATATGCT	3
KRS14GTC	TATGAAATTGGTAAAGTATTTAGAAATGAAGGTATAGATAATACACATAATCCTGTCTTTACTTCGTGTGAATTTTATTGGGCATATGCT	1
KRS14GTA	TATGAAATTGGTAAAGTATTTAGAAATGAAGGTATAGATAATACACATAATCCTGTATTTACTTCGTGTGAATTTTATTGGGCATATGCT	29
KRS14GTG	TATGAAATTGGTAAAGTATTTAGAAATGAAGGTATAGATAATACACATAATCCTGTGTTTACTTCGTGTGAATTTTATTGGGCATATGCT	2
KRS14TCT	TATGAAATTGGTAAAGTATTTAGAAATGAAGGTATAGATAATACACATAATCCTTCTTTTACTTCGTGTGAATTTTATTGGGCATATGCT	9
KRS14TCC	TATGAAATTGGTAAAGTATTTAGAAATGAAGGTATAGATAATACACATAATCCTTCCTTTACTTCGTGTGAATTTTATTGGGCATATGCT	1
KRS14TCA	TATGAAATTGGTAAAGTATTTAGAAATGAAGGTATAGATAATACACATAATCCTTCATTTACTTCGTGTGAATTTTATTGGGCATATGCT	0
KRS14TCG	TATGAAATTGGTAAAGTATTTAGAAATGAAGGTATAGATAATACACATAATCCTTCGTTTACTTCGTGTGAATTTTATTGGGCATATGCT	0
KRS14CCT	TATGAAATTGGTAAAGTATTTAGAAATGAAGGTATAGATAATACACATAATCCTCCTTTTACTTCGTGTGAATTTTATTGGGCATATGCT	0
KRS14CCC	TATGAAATTGGTAAAGTATTTAGAAATGAAGGTATAGATAATACACATAATCCTCCCTTTACTTCGTGTGAATTTTATTGGGCATATGCT	0
KRS14CCA	TATGAAATTGGTAAAGTATTTAGAAATGAAGGTATAGATAATACACATAATCCTCCATTTACTTCGTGTGAATTTTATTGGGCATATGCT	1
KRS14CCG	TATGAAATTGGTAAAGTATTTAGAAATGAAGGTATAGATAATACACATAATCCTCCGTTTACTTCGTGTGAATTTTATTGGGCATATGCT	1
KRS14ACT	TATGAAATTGGTAAAGTATTTAGAAATGAAGGTATAGATAATACACATAATCCTACTTTTACTTCGTGTGAATTTTATTGGGCATATGCT	0
KRS14ACC	TATGAAATTGGTAAAGTATTTAGAAATGAAGGTATAGATAATACACATAATCCTACCTTTACTTCGTGTGAATTTTATTGGGCATATGCT	0
KRS14ACA	TATGAAATTGGTAAAGTATTTAGAAATGAAGGTATAGATAATACACATAATCCTACATTTACTTCGTGTGAATTTTATTGGGCATATGCT	11
KRS14ACG	TATGAAATTGGTAAAGTATTTAGAAATGAAGGTATAGATAATACACATAATCCTACGTTTACTTCGTGTGAATTTTATTGGGCATATGCT	0
KRS14GCT	TATGAAATTGGTAAAGTATTTAGAAATGAAGGTATAGATAATACACATAATCCTGCTTTTACTTCGTGTGAATTTTATTGGGCATATGCT	3
KRS14GCC	TATGAAATTGGTAAAGTATTTAGAAATGAAGGTATAGATAATACACATAATCCTGCCTTTACTTCGTGTGAATTTTATTGGGCATATGCT	0
KRS14GCA	TATGAAATTGGTAAAGTATTTAGAAATGAAGGTATAGATAATACACATAATCCTGCATTTACTTCGTGTGAATTTTATTGGGCATATGCT	13
KRS14GCG	TATGAAATTGGTAAAGTATTTAGAAATGAAGGTATAGATAATACACATAATCCTGCGTTTACTTCGTGTGAATTTTATTGGGCATATGCT	2
KRS14TAT	TATGAAATTGGTAAAGTATTTAGAAATGAAGGTATAGATAATACACATAATCCTTATTTTACTTCGTGTGAATTTTATTGGGCATATGCT	83
KRS14TAC	TATGAAATTGGTAAAGTATTTAGAAATGAAGGTATAGATAATACACATAATCCTTACTTTACTTCGTGTGAATTTTATTGGGCATATGCT	0
KRS14TAA	TATGAAATTGGTAAAGTATTTAGAAATGAAGGTATAGATAATACACATAATCCTTAATTTACTTCGTGTGAATTTTATTGGGCATATGCT	10
KRS14TAG	TATGAAATTGGTAAAGTATTTAGAAATGAAGGTATAGATAATACACATAATCCTTAGTTTACTTCGTGTGAATTTTATTGGGCATATGCT	0
KRS14CAT	TATGAAATTGGTAAAGTATTTAGAAATGAAGGTATAGATAATACACATAATCCTCATTTTACTTCGTGTGAATTTTATTGGGCATATGCT	0
KRS14CAC	TATGAAATTGGTAAAGTATTTAGAAATGAAGGTATAGATAATACACATAATCCTCACTTTACTTCGTGTGAATTTTATTGGGCATATGCT	0
KRS14CAA	TATGAAATTGGTAAAGTATTTAGAAATGAAGGTATAGATAATACACATAATCCTCAATTTACTTCGTGTGAATTTTATTGGGCATATGCT	28
KRS14CAG	TATGAAATTGGTAAAGTATTTAGAAATGAAGGTATAGATAATACACATAATCCTCAGTTTACTTCGTGTGAATTTTATTGGGCATATGCT	0
KRS14AAT	TATGAAATTGGTAAAGTATTTAGAAATGAAGGTATAGATAATACACATAATCCTAATTTTACTTCGTGTGAATTTTATTGGGCATATGCT	3
KRS14AAC	TATGAAATTGGTAAAGTATTTAGAAATGAAGGTATAGATAATACACATAATCCTAACTTTACTTCGTGTGAATTTTATTGGGCATATGCT	0
KRS14AAA	TATGAAATTGGTAAAGTATTTAGAAATGAAGGTATAGATAATACACATAATCCTAAATTTACTTCGTGTGAATTTTATTGGGCATATGCT	26
KRS14AAG	TATGAAATTGGTAAAGTATTTAGAAATGAAGGTATAGATAATACACATAATCCTAAGTTTACTTCGTGTGAATTTTATTGGGCATATGCT	0
KRS14GAT	TATGAAATTGGTAAAGTATTTAGAAATGAAGGTATAGATAATACACATAATCCTGATTTTACTTCGTGTGAATTTTATTGGGCATATGCT	136
KRS14GAC	TATGAAATTGGTAAAGTATTTAGAAATGAAGGTATAGATAATACACATAATCCTGACTTTACTTCGTGTGAATTTTATTGGGCATATGCT	10
KRS14GAA	TATGAAATTGGTAAAGTATTTAGAAATGAAGGTATAGATAATACACATAATCCTGAATTTACTTCGTGTGAATTTTATTGGGCATATGCT	40702
KRS14GAG	TATGAAATTGGTAAAGTATTTAGAAATGAAGGTATAGATAATACACATAATCCTGAGTTTACTTCGTGTGAATTTTATTGGGCATATGCT	77
KRS14TGT	TATGAAATTGGTAAAGTATTTAGAAATGAAGGTATAGATAATACACATAATCCTTGTTTTACTTCGTGTGAATTTTATTGGGCATATGCT	3
KRS14TGC	TATGAAATTGGTAAAGTATTTAGAAATGAAGGTATAGATAATACACATAATCCTTGCTTTACTTCGTGTGAATTTTATTGGGCATATGCT	3
KRS14TGA	TATGAAATTGGTAAAGTATTTAGAAATGAAGGTATAGATAATACACATAATCCTTGATTTACTTCGTGTGAATTTTATTGGGCATATGCT	0
KRS14TGG	TATGAAATTGGTAAAGTATTTAGAAATGAAGGTATAGATAATACACATAATCCTTGGTTTACTTCGTGTGAATTTTATTGGGCATATGCT	0
KRS14CGT	TATGAAATTGGTAAAGTATTTAGAAATGAAGGTATAGATAATACACATAATCCTCGTTTTACTTCGTGTGAATTTTATTGGGCATATGCT	0
KRS14CGC	TATGAAATTGGTAAAGTATTTAGAAATGAAGGTATAGATAATACACATAATCCTCGCTTTACTTCGTGTGAATTTTATTGGGCATATGCT	3
KRS14CGA	TATGAAATTGGTAAAGTATTTAGAAATGAAGGTATAGATAATACACATAATCCTCGATTTACTTCGTGTGAATTTTATTGGGCATATGCT	0
KRS14CGG	TATGAAATTGGTAAAGTATTTAGAAATGAAGGTATAGATAATACACATAATCCTCGGTTTACTTCGTGTGAATTTTATTGGGCATATGCT	0
KRS14AGT	TATGAAATTGGTAAAGTATTTAGAAATGAAGGTATAGATAATACACATAATCCTAGTTTTACTTCGTGTGAATTTTATTGGGCATATGCT	9
KRS14AGC	TATGAAATTGGTAAAGTATTTAGAAATGAAGGTATAGATAATACACATAATCCTAGCTTTACTTCGTGTGAATTTTATTGGGCATATGCT	103
KRS14AGA	TATGAAATTGGTAAAGTATTTAGAAATGAAGGTATAGATAATACACATAATCCTAGATTTACTTCGTGTGAATTTTATTGGGCATATGCT	0
KRS14AGG	TATGAAATTGGTAAAGTATTTAGAAATGAAGGTATAGATAATACACATAATCCTAGGTTTACTTCGTGTGAATTTTATTGGGCATATGCT	3
KRS14GGT	TATGAAATTGGTAAAGTATTTAGAAATGAAGGTATAGATAATACACATAATCCTGGTTTTACTTCGTGTGAATTTTATTGGGCATATGCT	0
KRS14GGC	TATGAAATTGGTAAAGTATTTAGAAATGAAGGTATAGATAATACACATAATCCTGGCTTTACTTCGTGTGAATTTTATTGGGCATATGCT	1
KRS14GGA	TATGAAATTGGTAAAGTATTTAGAAATGAAGGTATAGATAATACACATAATCCTGGATTTACTTCGTGTGAATTTTATTGGGCATATGCT	71
KRS14GGG	TATGAAATTGGTAAAGTATTTAGAAATGAAGGTATAGATAATACACATAATCCTGGGTTTACTTCGTGTGAATTTTATTGGGCATATGCT	0
KRS15TTT	TATGAAATTGGTAAAGTATTTAGAAATGAAGGTATAGATAATACACATAATCCTGAATTTACTTCGTGTGAATTTTATTGGGCATATGCT	40702
KRS15TTC	TATGAAATTGGTAAAGTATTTAGAAATGAAGGTATAGATAATACACATAATCCTGAATTCACTTCGTGTGAATTTTATTGGGCATATGCT	719
KRS15TTA	TATGAAATTGGTAAAGTATTTAGAAATGAAGGTATAGATAATACACATAATCCTGAATTAACTTCGTGTGAATTTTATTGGGCATATGCT	19
KRS15TTG	TATGAAATTGGTAAAGTATTTAGAAATGAAGGTATAGATAATACACATAATCCTGAATTGACTTCGTGTGAATTTTATTGGGCATATGCT	7
KRS15CTT	TATGAAATTGGTAAAGTATTTAGAAATGAAGGTATAGATAATACACATAATCCTGAACTTACTTCGTGTGAATTTTATTGGGCATATGCT	64
KRS15CTC	TATGAAATTGGTAAAGTATTTAGAAATGAAGGTATAGATAATACACATAATCCTGAACTCACTTCGTGTGAATTTTATTGGGCATATGCT	2
KRS15CTA	TATGAAATTGGTAAAGTATTTAGAAATGAAGGTATAGATAATACACATAATCCTGAACTAACTTCGTGTGAATTTTATTGGGCATATGCT	0
KRS15CTG	TATGAAATTGGTAAAGTATTTAGAAATGAAGGTATAGATAATACACATAATCCTGAACTGACTTCGTGTGAATTTTATTGGGCATATGCT	0
KRS15ATT	TATGAAATTGGTAAAGTATTTAGAAATGAAGGTATAGATAATACACATAATCCTGAAATTACTTCGTGTGAATTTTATTGGGCATATGCT	543
KRS15ATC	TATGAAATTGGTAAAGTATTTAGAAATGAAGGTATAGATAATACACATAATCCTGAAATCACTTCGTGTGAATTTTATTGGGCATATGCT	4
KRS15ATA	TATGAAATTGGTAAAGTATTTAGAAATGAAGGTATAGATAATACACATAATCCTGAAATAACTTCGTGTGAATTTTATTGGGCATATGCT	5
KRS15ATG	TATGAAATTGGTAAAGTATTTAGAAATGAAGGTATAGATAATACACATAATCCTGAAATGACTTCGTGTGAATTTTATTGGGCATATGCT	2
KRS15GTT	TATGAAATTGGTAAAGTATTTAGAAATGAAGGTATAGATAATACACATAATCCTGAAGTTACTTCGTGTGAATTTTATTGGGCATATGCT	10
KRS15GTC	TATGAAATTGGTAAAGTATTTAGAAATGAAGGTATAGATAATACACATAATCCTGAAGTCACTTCGTGTGAATTTTATTGGGCATATGCT	0
KRS15GTA	TATGAAATTGGTAAAGTATTTAGAAATGAAGGTATAGATAATACACATAATCCTGAAGTAACTTCGTGTGAATTTTATTGGGCATATGCT	3
KRS15GTG	TATGAAATTGGTAAAGTATTTAGAAATGAAGGTATAGATAATACACATAATCCTGAAGTGACTTCGTGTGAATTTTATTGGGCATATGCT	3
KRS15TCT	TATGAAATTGGTAAAGTATTTAGAAATGAAGGTATAGATAATACACATAATCCTGAATCTACTTCGTGTGAATTTTATTGGGCATATGCT	84
KRS15TCC	TATGAAATTGGTAAAGTATTTAGAAATGAAGGTATAGATAATACACATAATCCTGAATCCACTTCGTGTGAATTTTATTGGGCATATGCT	366
KRS15TCA	TATGAAATTGGTAAAGTATTTAGAAATGAAGGTATAGATAATACACATAATCCTGAATCAACTTCGTGTGAATTTTATTGGGCATATGCT	6
KRS15TCG	TATGAAATTGGTAAAGTATTTAGAAATGAAGGTATAGATAATACACATAATCCTGAATCGACTTCGTGTGAATTTTATTGGGCATATGCT	1
KRS15CCT	TATGAAATTGGTAAAGTATTTAGAAATGAAGGTATAGATAATACACATAATCCTGAACCTACTTCGTGTGAATTTTATTGGGCATATGCT	2
KRS15CCC	TATGAAATTGGTAAAGTATTTAGAAATGAAGGTATAGATAATACACATAATCCTGAACCCACTTCGTGTGAATTTTATTGGGCATATGCT	2
KRS15CCA	TATGAAATTGGTAAAGTATTTAGAAATGAAGGTATAGATAATACACATAATCCTGAACCAACTTCGTGTGAATTTTATTGGGCATATGCT	2
KRS15CCG	TATGAAATTGGTAAAGTATTTAGAAATGAAGGTATAGATAATACACATAATCCTGAACCGACTTCGTGTGAATTTTATTGGGCATATGCT	1
KRS15ACT	TATGAAATTGGTAAAGTATTTAGAAATGAAGGTATAGATAATACACATAATCCTGAAACTACTTCGTGTGAATTTTATTGGGCATATGCT	1
KRS15ACC	TATGAAATTGGTAAAGTATTTAGAAATGAAGGTATAGATAATACACATAATCCTGAAACCACTTCGTGTGAATTTTATTGGGCATATGCT	1
KRS15ACA	TATGAAATTGGTAAAGTATTTAGAAATGAAGGTATAGATAATACACATAATCCTGAAACAACTTCGTGTGAATTTTATTGGGCATATGCT	632
KRS15ACG	TATGAAATTGGTAAAGTATTTAGAAATGAAGGTATAGATAATACACATAATCCTGAAACGACTTCGTGTGAATTTTATTGGGCATATGCT	2
KRS15GCT	TATGAAATTGGTAAAGTATTTAGAAATGAAGGTATAGATAATACACATAATCCTGAAGCTACTTCGTGTGAATTTTATTGGGCATATGCT	7
KRS15GCC	TATGAAATTGGTAAAGTATTTAGAAATGAAGGTATAGATAATACACATAATCCTGAAGCCACTTCGTGTGAATTTTATTGGGCATATGCT	0
KRS15GCA	TATGAAATTGGTAAAGTATTTAGAAATGAAGGTATAGATAATACACATAATCCTGAAGCAACTTCGTGTGAATTTTATTGGGCATATGCT	5
KRS15GCG	TATGAAATTGGTAAAGTATTTAGAAATGAAGGTATAGATAATACACATAATCCTGAAGCGACTTCGTGTGAATTTTATTGGGCATATGCT	1
KRS15TAT	TATGAAATTGGTAAAGTATTTAGAAATGAAGGTATAGATAATACACATAATCCTGAATATACTTCGTGTGAATTTTATTGGGCATATGCT	6776
KRS15TAC	TATGAAATTGGTAAAGTATTTAGAAATGAAGGTATAGATAATACACATAATCCTGAATACACTTCGTGTGAATTTTATTGGGCATATGCT	393107
KRS15TAA	TATGAAATTGGTAAAGTATTTAGAAATGAAGGTATAGATAATACACATAATCCTGAATAAACTTCGTGTGAATTTTATTGGGCATATGCT	24
KRS15TAG	TATGAAATTGGTAAAGTATTTAGAAATGAAGGTATAGATAATACACATAATCCTGAATAGACTTCGTGTGAATTTTATTGGGCATATGCT	187
KRS15CAT	TATGAAATTGGTAAAGTATTTAGAAATGAAGGTATAGATAATACACATAATCCTGAACATACTTCGTGTGAATTTTATTGGGCATATGCT	3222
KRS15CAC	TATGAAATTGGTAAAGTATTTAGAAATGAAGGTATAGATAATACACATAATCCTGAACACACTTCGTGTGAATTTTATTGGGCATATGCT	1617
KRS15CAA	TATGAAATTGGTAAAGTATTTAGAAATGAAGGTATAGATAATACACATAATCCTGAACAAACTTCGTGTGAATTTTATTGGGCATATGCT	8
KRS15CAG	TATGAAATTGGTAAAGTATTTAGAAATGAAGGTATAGATAATACACATAATCCTGAACAGACTTCGTGTGAATTTTATTGGGCATATGCT	0
KRS15AAT	TATGAAATTGGTAAAGTATTTAGAAATGAAGGTATAGATAATACACATAATCCTGAAAATACTTCGTGTGAATTTTATTGGGCATATGCT	6
KRS15AAC	TATGAAATTGGTAAAGTATTTAGAAATGAAGGTATAGATAATACACATAATCCTGAAAACACTTCGTGTGAATTTTATTGGGCATATGCT	123
KRS15AAA	TATGAAATTGGTAAAGTATTTAGAAATGAAGGTATAGATAATACACATAATCCTGAAAAAACTTCGTGTGAATTTTATTGGGCATATGCT	15
KRS15AAG	TATGAAATTGGTAAAGTATTTAGAAATGAAGGTATAGATAATACACATAATCCTGAAAAGACTTCGTGTGAATTTTATTGGGCATATGCT	6
KRS15GAT	TATGAAATTGGTAAAGTATTTAGAAATGAAGGTATAGATAATACACATAATCCTGAAGATACTTCGTGTGAATTTTATTGGGCATATGCT	7
KRS15GAC	TATGAAATTGGTAAAGTATTTAGAAATGAAGGTATAGATAATACACATAATCCTGAAGACACTTCGTGTGAATTTTATTGGGCATATGCT	31
KRS15GAA	TATGAAATTGGTAAAGTATTTAGAAATGAAGGTATAGATAATACACATAATCCTGAAGAAACTTCGTGTGAATTTTATTGGGCATATGCT	5
KRS15GAG	TATGAAATTGGTAAAGTATTTAGAAATGAAGGTATAGATAATACACATAATCCTGAAGAGACTTCGTGTGAATTTTATTGGGCATATGCT	2
KRS15TGT	TATGAAATTGGTAAAGTATTTAGAAATGAAGGTATAGATAATACACATAATCCTGAATGTACTTCGTGTGAATTTTATTGGGCATATGCT	15
KRS15TGC	TATGAAATTGGTAAAGTATTTAGAAATGAAGGTATAGATAATACACATAATCCTGAATGCACTTCGTGTGAATTTTATTGGGCATATGCT	461
KRS15TGA	TATGAAATTGGTAAAGTATTTAGAAATGAAGGTATAGATAATACACATAATCCTGAATGAACTTCGTGTGAATTTTATTGGGCATATGCT	1
KRS15TGG	TATGAAATTGGTAAAGTATTTAGAAATGAAGGTATAGATAATACACATAATCCTGAATGGACTTCGTGTGAATTTTATTGGGCATATGCT	338
KRS15CGT	TATGAAATTGGTAAAGTATTTAGAAATGAAGGTATAGATAATACACATAATCCTGAACGTACTTCGTGTGAATTTTATTGGGCATATGCT	5
KRS15CGC	TATGAAATTGGTAAAGTATTTAGAAATGAAGGTATAGATAATACACATAATCCTGAACGCACTTCGTGTGAATTTTATTGGGCATATGCT	4
KRS15CGA	TATGAAATTGGTAAAGTATTTAGAAATGAAGGTATAGATAATACACATAATCCTGAACGAACTTCGTGTGAATTTTATTGGGCATATGCT	0
KRS15CGG	TATGAAATTGGTAAAGTATTTAGAAATGAAGGTATAGATAATACACATAATCCTGAACGGACTTCGTGTGAATTTTATTGGGCATATGCT	1
KRS15AGT	TATGAAATTGGTAAAGTATTTAGAAATGAAGGTATAGATAATACACATAATCCTGAAAGTACTTCGTGTGAATTTTATTGGGCATATGCT	1
KRS15AGC	TATGAAATTGGTAAAGTATTTAGAAATGAAGGTATAGATAATACACATAATCCTGAAAGCACTTCGTGTGAATTTTATTGGGCATATGCT	1
KRS15AGA	TATGAAATTGGTAAAGTATTTAGAAATGAAGGTATAGATAATACACATAATCCTGAAAGAACTTCGTGTGAATTTTATTGGGCATATGCT	10
KRS15AGG	TATGAAATTGGTAAAGTATTTAGAAATGAAGGTATAGATAATACACATAATCCTGAAAGGACTTCGTGTGAATTTTATTGGGCATATGCT	1
KRS15GGT	TATGAAATTGGTAAAGTATTTAGAAATGAAGGTATAGATAATACACATAATCCTGAAGGTACTTCGTGTGAATTTTATTGGGCATATGCT	1
KRS15GGC	TATGAAATTGGTAAAGTATTTAGAAATGAAGGTATAGATAATACACATAATCCTGAAGGCACTTCGTGTGAATTTTATTGGGCATATGCT	6
KRS15GGA	TATGAAATTGGTAAAGTATTTAGAAATGAAGGTATAGATAATACACATAATCCTGAAGGAACTTCGTGTGAATTTTATTGGGCATATGCT	2
KRS15GGG	TATGAAATTGGTAAAGTATTTAGAAATGAAGGTATAGATAATACACATAATCCTGAAGGGACTTCGTGTGAATTTTATTGGGCATATGCT	9
KRS16TTT	TATGAAATTGGTAAAGTATTTAGAAATGAAGGTATAGATAATACACATAATCCTGAATTTTTTTCGTGTGAATTTTATTGGGCATATGCT	1
KRS16TTC	TATGAAATTGGTAAAGTATTTAGAAATGAAGGTATAGATAATACACATAATCCTGAATTTTTCTCGTGTGAATTTTATTGGGCATATGCT	1
KRS16TTA	TATGAAATTGGTAAAGTATTTAGAAATGAAGGTATAGATAATACACATAATCCTGAATTTTTATCGTGTGAATTTTATTGGGCATATGCT	120
KRS16TTG	TATGAAATTGGTAAAGTATTTAGAAATGAAGGTATAGATAATACACATAATCCTGAATTTTTGTCGTGTGAATTTTATTGGGCATATGCT	1
KRS16CTT	TATGAAATTGGTAAAGTATTTAGAAATGAAGGTATAGATAATACACATAATCCTGAATTTCTTTCGTGTGAATTTTATTGGGCATATGCT	0
KRS16CTC	TATGAAATTGGTAAAGTATTTAGAAATGAAGGTATAGATAATACACATAATCCTGAATTTCTCTCGTGTGAATTTTATTGGGCATATGCT	0
KRS16CTA	TATGAAATTGGTAAAGTATTTAGAAATGAAGGTATAGATAATACACATAATCCTGAATTTCTATCGTGTGAATTTTATTGGGCATATGCT	9
KRS16CTG	TATGAAATTGGTAAAGTATTTAGAAATGAAGGTATAGATAATACACATAATCCTGAATTTCTGTCGTGTGAATTTTATTGGGCATATGCT	0
KRS16ATT	TATGAAATTGGTAAAGTATTTAGAAATGAAGGTATAGATAATACACATAATCCTGAATTTATTTCGTGTGAATTTTATTGGGCATATGCT	20
KRS16ATC	TATGAAATTGGTAAAGTATTTAGAAATGAAGGTATAGATAATACACATAATCCTGAATTTATCTCGTGTGAATTTTATTGGGCATATGCT	517
KRS16ATA	TATGAAATTGGTAAAGTATTTAGAAATGAAGGTATAGATAATACACATAATCCTGAATTTATATCGTGTGAATTTTATTGGGCATATGCT	9
KRS16ATG	TATGAAATTGGTAAAGTATTTAGAAATGAAGGTATAGATAATACACATAATCCTGAATTTATGTCGTGTGAATTTTATTGGGCATATGCT	6
KRS16GTT	TATGAAATTGGTAAAGTATTTAGAAATGAAGGTATAGATAATACACATAATCCTGAATTTGTTTCGTGTGAATTTTATTGGGCATATGCT	2
KRS16GTC	TATGAAATTGGTAAAGTATTTAGAAATGAAGGTATAGATAATACACATAATCCTGAATTTGTCTCGTGTGAATTTTATTGGGCATATGCT	1
KRS16GTA	TATGAAATTGGTAAAGTATTTAGAAATGAAGGTATAGATAATACACATAATCCTGAATTTGTATCGTGTGAATTTTATTGGGCATATGCT	2
KRS16GTG	TATGAAATTGGTAAAGTATTTAGAAATGAAGGTATAGATAATACACATAATCCTGAATTTGTGTCGTGTGAATTTTATTGGGCATATGCT	4
KRS16TCT	TATGAAATTGGTAAAGTATTTAGAAATGAAGGTATAGATAATACACATAATCCTGAATTTTCTTCGTGTGAATTTTATTGGGCATATGCT	64
KRS16TCC	TATGAAATTGGTAAAGTATTTAGAAATGAAGGTATAGATAATACACATAATCCTGAATTTTCCTCGTGTGAATTTTATTGGGCATATGCT	3
KRS16TCA	TATGAAATTGGTAAAGTATTTAGAAATGAAGGTATAGATAATACACATAATCCTGAATTTTCATCGTGTGAATTTTATTGGGCATATGCT	44
KRS16TCG	TATGAAATTGGTAAAGTATTTAGAAATGAAGGTATAGATAATACACATAATCCTGAATTTTCGTCGTGTGAATTTTATTGGGCATATGCT	1
KRS16CCT	TATGAAATTGGTAAAGTATTTAGAAATGAAGGTATAGATAATACACATAATCCTGAATTTCCTTCGTGTGAATTTTATTGGGCATATGCT	20
KRS16CCC	TATGAAATTGGTAAAGTATTTAGAAATGAAGGTATAGATAATACACATAATCCTGAATTTCCCTCGTGTGAATTTTATTGGGCATATGCT	4
KRS16CCA	TATGAAATTGGTAAAGTATTTAGAAATGAAGGTATAGATAATACACATAATCCTGAATTTCCATCGTGTGAATTTTATTGGGCATATGCT	1
KRS16CCG	TATGAAATTGGTAAAGTATTTAGAAATGAAGGTATAGATAATACACATAATCCTGAATTTCCGTCGTGTGAATTTTATTGGGCATATGCT	1
KRS16ACT	TATGAAATTGGTAAAGTATTTAGAAATGAAGGTATAGATAATACACATAATCCTGAATTTACTTCGTGTGAATTTTATTGGGCATATGCT	40702
KRS16ACC	TATGAAATTGGTAAAGTATTTAGAAATGAAGGTATAGATAATACACATAATCCTGAATTTACCTCGTGTGAATTTTATTGGGCATATGCT	2694
KRS16ACA	TATGAAATTGGTAAAGTATTTAGAAATGAAGGTATAGATAATACACATAATCCTGAATTTACATCGTGTGAATTTTATTGGGCATATGCT	47
KRS16ACG	TATGAAATTGGTAAAGTATTTAGAAATGAAGGTATAGATAATACACATAATCCTGAATTTACGTCGTGTGAATTTTATTGGGCATATGCT	10
KRS16GCT	TATGAAATTGGTAAAGTATTTAGAAATGAAGGTATAGATAATACACATAATCCTGAATTTGCTTCGTGTGAATTTTATTGGGCATATGCT	58
KRS16GCC	TATGAAATTGGTAAAGTATTTAGAAATGAAGGTATAGATAATACACATAATCCTGAATTTGCCTCGTGTGAATTTTATTGGGCATATGCT	7
KRS16GCA	TATGAAATTGGTAAAGTATTTAGAAATGAAGGTATAGATAATACACATAATCCTGAATTTGCATCGTGTGAATTTTATTGGGCATATGCT	1
KRS16GCG	TATGAAATTGGTAAAGTATTTAGAAATGAAGGTATAGATAATACACATAATCCTGAATTTGCGTCGTGTGAATTTTATTGGGCATATGCT	5
KRS16TAT	TATGAAATTGGTAAAGTATTTAGAAATGAAGGTATAGATAATACACATAATCCTGAATTTTATTCGTGTGAATTTTATTGGGCATATGCT	137
KRS16TAC	TATGAAATTGGTAAAGTATTTAGAAATGAAGGTATAGATAATACACATAATCCTGAATTTTACTCGTGTGAATTTTATTGGGCATATGCT	23
KRS16TAA	TATGAAATTGGTAAAGTATTTAGAAATGAAGGTATAGATAATACACATAATCCTGAATTTTAATCGTGTGAATTTTATTGGGCATATGCT	151132
KRS16TAG	TATGAAATTGGTAAAGTATTTAGAAATGAAGGTATAGATAATACACATAATCCTGAATTTTAGTCGTGTGAATTTTATTGGGCATATGCT	219
KRS16CAT	TATGAAATTGGTAAAGTATTTAGAAATGAAGGTATAGATAATACACATAATCCTGAATTTCATTCGTGTGAATTTTATTGGGCATATGCT	0
KRS16CAC	TATGAAATTGGTAAAGTATTTAGAAATGAAGGTATAGATAATACACATAATCCTGAATTTCACTCGTGTGAATTTTATTGGGCATATGCT	0
KRS16CAA	TATGAAATTGGTAAAGTATTTAGAAATGAAGGTATAGATAATACACATAATCCTGAATTTCAATCGTGTGAATTTTATTGGGCATATGCT	128
KRS16CAG	TATGAAATTGGTAAAGTATTTAGAAATGAAGGTATAGATAATACACATAATCCTGAATTTCAGTCGTGTGAATTTTATTGGGCATATGCT	0
KRS16AAT	TATGAAATTGGTAAAGTATTTAGAAATGAAGGTATAGATAATACACATAATCCTGAATTTAATTCGTGTGAATTTTATTGGGCATATGCT	6
KRS16AAC	TATGAAATTGGTAAAGTATTTAGAAATGAAGGTATAGATAATACACATAATCCTGAATTTAACTCGTGTGAATTTTATTGGGCATATGCT	3
KRS16AAA	TATGAAATTGGTAAAGTATTTAGAAATGAAGGTATAGATAATACACATAATCCTGAATTTAAATCGTGTGAATTTTATTGGGCATATGCT	105
KRS16AAG	TATGAAATTGGTAAAGTATTTAGAAATGAAGGTATAGATAATACACATAATCCTGAATTTAAGTCGTGTGAATTTTATTGGGCATATGCT	3
KRS16GAT	TATGAAATTGGTAAAGTATTTAGAAATGAAGGTATAGATAATACACATAATCCTGAATTTGATTCGTGTGAATTTTATTGGGCATATGCT	0
KRS16GAC	TATGAAATTGGTAAAGTATTTAGAAATGAAGGTATAGATAATACACATAATCCTGAATTTGACTCGTGTGAATTTTATTGGGCATATGCT	0
KRS16GAA	TATGAAATTGGTAAAGTATTTAGAAATGAAGGTATAGATAATACACATAATCCTGAATTTGAATCGTGTGAATTTTATTGGGCATATGCT	16
KRS16GAG	TATGAAATTGGTAAAGTATTTAGAAATGAAGGTATAGATAATACACATAATCCTGAATTTGAGTCGTGTGAATTTTATTGGGCATATGCT	1
KRS16TGT	TATGAAATTGGTAAAGTATTTAGAAATGAAGGTATAGATAATACACATAATCCTGAATTTTGTTCGTGTGAATTTTATTGGGCATATGCT	11
KRS16TGC	TATGAAATTGGTAAAGTATTTAGAAATGAAGGTATAGATAATACACATAATCCTGAATTTTGCTCGTGTGAATTTTATTGGGCATATGCT	6
KRS16TGA	TATGAAATTGGTAAAGTATTTAGAAATGAAGGTATAGATAATACACATAATCCTGAATTTTGATCGTGTGAATTTTATTGGGCATATGCT	178
KRS16TGG	TATGAAATTGGTAAAGTATTTAGAAATGAAGGTATAGATAATACACATAATCCTGAATTTTGGTCGTGTGAATTTTATTGGGCATATGCT	1
KRS16CGT	TATGAAATTGGTAAAGTATTTAGAAATGAAGGTATAGATAATACACATAATCCTGAATTTCGTTCGTGTGAATTTTATTGGGCATATGCT	0
KRS16CGC	TATGAAATTGGTAAAGTATTTAGAAATGAAGGTATAGATAATACACATAATCCTGAATTTCGCTCGTGTGAATTTTATTGGGCATATGCT	1
KRS16CGA	TATGAAATTGGTAAAGTATTTAGAAATGAAGGTATAGATAATACACATAATCCTGAATTTCGATCGTGTGAATTTTATTGGGCATATGCT	4
KRS16CGG	TATGAAATTGGTAAAGTATTTAGAAATGAAGGTATAGATAATACACATAATCCTGAATTTCGGTCGTGTGAATTTTATTGGGCATATGCT	2
KRS16AGT	TATGAAATTGGTAAAGTATTTAGAAATGAAGGTATAGATAATACACATAATCCTGAATTTAGTTCGTGTGAATTTTATTGGGCATATGCT	47
KRS16AGC	TATGAAATTGGTAAAGTATTTAGAAATGAAGGTATAGATAATACACATAATCCTGAATTTAGCTCGTGTGAATTTTATTGGGCATATGCT	11
KRS16AGA	TATGAAATTGGTAAAGTATTTAGAAATGAAGGTATAGATAATACACATAATCCTGAATTTAGATCGTGTGAATTTTATTGGGCATATGCT	3
KRS16AGG	TATGAAATTGGTAAAGTATTTAGAAATGAAGGTATAGATAATACACATAATCCTGAATTTAGGTCGTGTGAATTTTATTGGGCATATGCT	4
KRS16GGT	TATGAAATTGGTAAAGTATTTAGAAATGAAGGTATAGATAATACACATAATCCTGAATTTGGTTCGTGTGAATTTTATTGGGCATATGCT	2
KRS16GGC	TATGAAATTGGTAAAGTATTTAGAAATGAAGGTATAGATAATACACATAATCCTGAATTTGGCTCGTGTGAATTTTATTGGGCATATGCT	1
KRS16GGA	TATGAAATTGGTAAAGTATTTAGAAATGAAGGTATAGATAATACACATAATCCTGAATTTGGATCGTGTGAATTTTATTGGGCATATGCT	0
KRS16GGG	TATGAAATTGGTAAAGTATTTAGAAATGAAGGTATAGATAATACACATAATCCTGAATTTGGGTCGTGTGAATTTTATTGGGCATATGCT	1
KRS17TTT	TATGAAATTGGTAAAGTATTTAGAAATGAAGGTATAGATAATACACATAATCCTGAATTTACTTTTTGTGAATTTTATTGGGCATATGCT	268
KRS17TTC	TATGAAATTGGTAAAGTATTTAGAAATGAAGGTATAGATAATACACATAATCCTGAATTTACTTTCTGTGAATTTTATTGGGCATATGCT	86
KRS17TTA	TATGAAATTGGTAAAGTATTTAGAAATGAAGGTATAGATAATACACATAATCCTGAATTTACTTTATGTGAATTTTATTGGGCATATGCT	618384
KRS17TTG	TATGAAATTGGTAAAGTATTTAGAAATGAAGGTATAGATAATACACATAATCCTGAATTTACTTTGTGTGAATTTTATTGGGCATATGCT	1918
KRS17CTT	TATGAAATTGGTAAAGTATTTAGAAATGAAGGTATAGATAATACACATAATCCTGAATTTACTCTTTGTGAATTTTATTGGGCATATGCT	6384
KRS17CTC	TATGAAATTGGTAAAGTATTTAGAAATGAAGGTATAGATAATACACATAATCCTGAATTTACTCTCTGTGAATTTTATTGGGCATATGCT	54
KRS17CTA	TATGAAATTGGTAAAGTATTTAGAAATGAAGGTATAGATAATACACATAATCCTGAATTTACTCTATGTGAATTTTATTGGGCATATGCT	18608
KRS17CTG	TATGAAATTGGTAAAGTATTTAGAAATGAAGGTATAGATAATACACATAATCCTGAATTTACTCTGTGTGAATTTTATTGGGCATATGCT	1021
KRS17ATT	TATGAAATTGGTAAAGTATTTAGAAATGAAGGTATAGATAATACACATAATCCTGAATTTACTATTTGTGAATTTTATTGGGCATATGCT	77914
KRS17ATC	TATGAAATTGGTAAAGTATTTAGAAATGAAGGTATAGATAATACACATAATCCTGAATTTACTATCTGTGAATTTTATTGGGCATATGCT	62527
KRS17ATA	TATGAAATTGGTAAAGTATTTAGAAATGAAGGTATAGATAATACACATAATCCTGAATTTACTATATGTGAATTTTATTGGGCATATGCT	10225
KRS17ATG	TATGAAATTGGTAAAGTATTTAGAAATGAAGGTATAGATAATACACATAATCCTGAATTTACTATGTGTGAATTTTATTGGGCATATGCT	190547
KRS17GTT	TATGAAATTGGTAAAGTATTTAGAAATGAAGGTATAGATAATACACATAATCCTGAATTTACTGTTTGTGAATTTTATTGGGCATATGCT	253
KRS17GTC	TATGAAATTGGTAAAGTATTTAGAAATGAAGGTATAGATAATACACATAATCCTGAATTTACTGTCTGTGAATTTTATTGGGCATATGCT	78
KRS17GTA	TATGAAATTGGTAAAGTATTTAGAAATGAAGGTATAGATAATACACATAATCCTGAATTTACTGTATGTGAATTTTATTGGGCATATGCT	201
KRS17GTG	TATGAAATTGGTAAAGTATTTAGAAATGAAGGTATAGATAATACACATAATCCTGAATTTACTGTGTGTGAATTTTATTGGGCATATGCT	11621
KRS17TCT	TATGAAATTGGTAAAGTATTTAGAAATGAAGGTATAGATAATACACATAATCCTGAATTTACTTCTTGTGAATTTTATTGGGCATATGCT	7
KRS17TCC	TATGAAATTGGTAAAGTATTTAGAAATGAAGGTATAGATAATACACATAATCCTGAATTTACTTCCTGTGAATTTTATTGGGCATATGCT	36
KRS17TCA	TATGAAATTGGTAAAGTATTTAGAAATGAAGGTATAGATAATACACATAATCCTGAATTTACTTCATGTGAATTTTATTGGGCATATGCT	708
KRS17TCG	TATGAAATTGGTAAAGTATTTAGAAATGAAGGTATAGATAATACACATAATCCTGAATTTACTTCGTGTGAATTTTATTGGGCATATGCT	40702
KRS17CCT	TATGAAATTGGTAAAGTATTTAGAAATGAAGGTATAGATAATACACATAATCCTGAATTTACTCCTTGTGAATTTTATTGGGCATATGCT	14
KRS17CCC	TATGAAATTGGTAAAGTATTTAGAAATGAAGGTATAGATAATACACATAATCCTGAATTTACTCCCTGTGAATTTTATTGGGCATATGCT	2
KRS17CCA	TATGAAATTGGTAAAGTATTTAGAAATGAAGGTATAGATAATACACATAATCCTGAATTTACTCCATGTGAATTTTATTGGGCATATGCT	25
KRS17CCG	TATGAAATTGGTAAAGTATTTAGAAATGAAGGTATAGATAATACACATAATCCTGAATTTACTCCGTGTGAATTTTATTGGGCATATGCT	139
KRS17ACT	TATGAAATTGGTAAAGTATTTAGAAATGAAGGTATAGATAATACACATAATCCTGAATTTACTACTTGTGAATTTTATTGGGCATATGCT	255
KRS17ACC	TATGAAATTGGTAAAGTATTTAGAAATGAAGGTATAGATAATACACATAATCCTGAATTTACTACCTGTGAATTTTATTGGGCATATGCT	188
KRS17ACA	TATGAAATTGGTAAAGTATTTAGAAATGAAGGTATAGATAATACACATAATCCTGAATTTACTACATGTGAATTTTATTGGGCATATGCT	1390
KRS17ACG	TATGAAATTGGTAAAGTATTTAGAAATGAAGGTATAGATAATACACATAATCCTGAATTTACTACGTGTGAATTTTATTGGGCATATGCT	432
KRS17GCT	TATGAAATTGGTAAAGTATTTAGAAATGAAGGTATAGATAATACACATAATCCTGAATTTACTGCTTGTGAATTTTATTGGGCATATGCT	1
KRS17GCC	TATGAAATTGGTAAAGTATTTAGAAATGAAGGTATAGATAATACACATAATCCTGAATTTACTGCCTGTGAATTTTATTGGGCATATGCT	2
KRS17GCA	TATGAAATTGGTAAAGTATTTAGAAATGAAGGTATAGATAATACACATAATCCTGAATTTACTGCATGTGAATTTTATTGGGCATATGCT	10
KRS17GCG	TATGAAATTGGTAAAGTATTTAGAAATGAAGGTATAGATAATACACATAATCCTGAATTTACTGCGTGTGAATTTTATTGGGCATATGCT	48
KRS17TAT	TATGAAATTGGTAAAGTATTTAGAAATGAAGGTATAGATAATACACATAATCCTGAATTTACTTATTGTGAATTTTATTGGGCATATGCT	17
KRS17TAC	TATGAAATTGGTAAAGTATTTAGAAATGAAGGTATAGATAATACACATAATCCTGAATTTACTTACTGTGAATTTTATTGGGCATATGCT	9
KRS17TAA	TATGAAATTGGTAAAGTATTTAGAAATGAAGGTATAGATAATACACATAATCCTGAATTTACTTAATGTGAATTTTATTGGGCATATGCT	2580
KRS17TAG	TATGAAATTGGTAAAGTATTTAGAAATGAAGGTATAGATAATACACATAATCCTGAATTTACTTAGTGTGAATTTTATTGGGCATATGCT	13
KRS17CAT	TATGAAATTGGTAAAGTATTTAGAAATGAAGGTATAGATAATACACATAATCCTGAATTTACTCATTGTGAATTTTATTGGGCATATGCT	4
KRS17CAC	TATGAAATTGGTAAAGTATTTAGAAATGAAGGTATAGATAATACACATAATCCTGAATTTACTCACTGTGAATTTTATTGGGCATATGCT	5
KRS17CAA	TATGAAATTGGTAAAGTATTTAGAAATGAAGGTATAGATAATACACATAATCCTGAATTTACTCAATGTGAATTTTATTGGGCATATGCT	13
KRS17CAG	TATGAAATTGGTAAAGTATTTAGAAATGAAGGTATAGATAATACACATAATCCTGAATTTACTCAGTGTGAATTTTATTGGGCATATGCT	3
KRS17AAT	TATGAAATTGGTAAAGTATTTAGAAATGAAGGTATAGATAATACACATAATCCTGAATTTACTAATTGTGAATTTTATTGGGCATATGCT	485
KRS17AAC	TATGAAATTGGTAAAGTATTTAGAAATGAAGGTATAGATAATACACATAATCCTGAATTTACTAACTGTGAATTTTATTGGGCATATGCT	977
KRS17AAA	TATGAAATTGGTAAAGTATTTAGAAATGAAGGTATAGATAATACACATAATCCTGAATTTACTAAATGTGAATTTTATTGGGCATATGCT	25
KRS17AAG	TATGAAATTGGTAAAGTATTTAGAAATGAAGGTATAGATAATACACATAATCCTGAATTTACTAAGTGTGAATTTTATTGGGCATATGCT	81
KRS17GAT	TATGAAATTGGTAAAGTATTTAGAAATGAAGGTATAGATAATACACATAATCCTGAATTTACTGATTGTGAATTTTATTGGGCATATGCT	0
KRS17GAC	TATGAAATTGGTAAAGTATTTAGAAATGAAGGTATAGATAATACACATAATCCTGAATTTACTGACTGTGAATTTTATTGGGCATATGCT	2
KRS17GAA	TATGAAATTGGTAAAGTATTTAGAAATGAAGGTATAGATAATACACATAATCCTGAATTTACTGAATGTGAATTTTATTGGGCATATGCT	0
KRS17GAG	TATGAAATTGGTAAAGTATTTAGAAATGAAGGTATAGATAATACACATAATCCTGAATTTACTGAGTGTGAATTTTATTGGGCATATGCT	6
KRS17TGT	TATGAAATTGGTAAAGTATTTAGAAATGAAGGTATAGATAATACACATAATCCTGAATTTACTTGTTGTGAATTTTATTGGGCATATGCT	1195
KRS17TGC	TATGAAATTGGTAAAGTATTTAGAAATGAAGGTATAGATAATACACATAATCCTGAATTTACTTGCTGTGAATTTTATTGGGCATATGCT	6
KRS17TGA	TATGAAATTGGTAAAGTATTTAGAAATGAAGGTATAGATAATACACATAATCCTGAATTTACTTGATGTGAATTTTATTGGGCATATGCT	59
KRS17TGG	TATGAAATTGGTAAAGTATTTAGAAATGAAGGTATAGATAATACACATAATCCTGAATTTACTTGGTGTGAATTTTATTGGGCATATGCT	43
KRS17CGT	TATGAAATTGGTAAAGTATTTAGAAATGAAGGTATAGATAATACACATAATCCTGAATTTACTCGTTGTGAATTTTATTGGGCATATGCT	7
KRS17CGC	TATGAAATTGGTAAAGTATTTAGAAATGAAGGTATAGATAATACACATAATCCTGAATTTACTCGCTGTGAATTTTATTGGGCATATGCT	1
KRS17CGA	TATGAAATTGGTAAAGTATTTAGAAATGAAGGTATAGATAATACACATAATCCTGAATTTACTCGATGTGAATTTTATTGGGCATATGCT	0
KRS17CGG	TATGAAATTGGTAAAGTATTTAGAAATGAAGGTATAGATAATACACATAATCCTGAATTTACTCGGTGTGAATTTTATTGGGCATATGCT	0
KRS17AGT	TATGAAATTGGTAAAGTATTTAGAAATGAAGGTATAGATAATACACATAATCCTGAATTTACTAGTTGTGAATTTTATTGGGCATATGCT	20
KRS17AGC	TATGAAATTGGTAAAGTATTTAGAAATGAAGGTATAGATAATACACATAATCCTGAATTTACTAGCTGTGAATTTTATTGGGCATATGCT	36
KRS17AGA	TATGAAATTGGTAAAGTATTTAGAAATGAAGGTATAGATAATACACATAATCCTGAATTTACTAGATGTGAATTTTATTGGGCATATGCT	6
KRS17AGG	TATGAAATTGGTAAAGTATTTAGAAATGAAGGTATAGATAATACACATAATCCTGAATTTACTAGGTGTGAATTTTATTGGGCATATGCT	27
KRS17GGT	TATGAAATTGGTAAAGTATTTAGAAATGAAGGTATAGATAATACACATAATCCTGAATTTACTGGTTGTGAATTTTATTGGGCATATGCT	193
KRS17GGC	TATGAAATTGGTAAAGTATTTAGAAATGAAGGTATAGATAATACACATAATCCTGAATTTACTGGCTGTGAATTTTATTGGGCATATGCT	10
KRS17GGA	TATGAAATTGGTAAAGTATTTAGAAATGAAGGTATAGATAATACACATAATCCTGAATTTACTGGATGTGAATTTTATTGGGCATATGCT	0
KRS17GGG	TATGAAATTGGTAAAGTATTTAGAAATGAAGGTATAGATAATACACATAATCCTGAATTTACTGGGTGTGAATTTTATTGGGCATATGCT	2
KRS18TTT	TATGAAATTGGTAAAGTATTTAGAAATGAAGGTATAGATAATACACATAATCCTGAATTTACTTCGTTTGAATTTTATTGGGCATATGCT	7
KRS18TTC	TATGAAATTGGTAAAGTATTTAGAAATGAAGGTATAGATAATACACATAATCCTGAATTTACTTCGTTCGAATTTTATTGGGCATATGCT	3
KRS18TTA	TATGAAATTGGTAAAGTATTTAGAAATGAAGGTATAGATAATACACATAATCCTGAATTTACTTCGTTAGAATTTTATTGGGCATATGCT	33
KRS18TTG	TATGAAATTGGTAAAGTATTTAGAAATGAAGGTATAGATAATACACATAATCCTGAATTTACTTCGTTGGAATTTTATTGGGCATATGCT	2
KRS18CTT	TATGAAATTGGTAAAGTATTTAGAAATGAAGGTATAGATAATACACATAATCCTGAATTTACTTCGCTTGAATTTTATTGGGCATATGCT	1
KRS18CTC	TATGAAATTGGTAAAGTATTTAGAAATGAAGGTATAGATAATACACATAATCCTGAATTTACTTCGCTCGAATTTTATTGGGCATATGCT	0
KRS18CTA	TATGAAATTGGTAAAGTATTTAGAAATGAAGGTATAGATAATACACATAATCCTGAATTTACTTCGCTAGAATTTTATTGGGCATATGCT	3
KRS18CTG	TATGAAATTGGTAAAGTATTTAGAAATGAAGGTATAGATAATACACATAATCCTGAATTTACTTCGCTGGAATTTTATTGGGCATATGCT	1
KRS18ATT	TATGAAATTGGTAAAGTATTTAGAAATGAAGGTATAGATAATACACATAATCCTGAATTTACTTCGATTGAATTTTATTGGGCATATGCT	207
KRS18ATC	TATGAAATTGGTAAAGTATTTAGAAATGAAGGTATAGATAATACACATAATCCTGAATTTACTTCGATCGAATTTTATTGGGCATATGCT	0
KRS18ATA	TATGAAATTGGTAAAGTATTTAGAAATGAAGGTATAGATAATACACATAATCCTGAATTTACTTCGATAGAATTTTATTGGGCATATGCT	221
KRS18ATG	TATGAAATTGGTAAAGTATTTAGAAATGAAGGTATAGATAATACACATAATCCTGAATTTACTTCGATGGAATTTTATTGGGCATATGCT	10
KRS18GTT	TATGAAATTGGTAAAGTATTTAGAAATGAAGGTATAGATAATACACATAATCCTGAATTTACTTCGGTTGAATTTTATTGGGCATATGCT	2
KRS18GTC	TATGAAATTGGTAAAGTATTTAGAAATGAAGGTATAGATAATACACATAATCCTGAATTTACTTCGGTCGAATTTTATTGGGCATATGCT	0
KRS18GTA	TATGAAATTGGTAAAGTATTTAGAAATGAAGGTATAGATAATACACATAATCCTGAATTTACTTCGGTAGAATTTTATTGGGCATATGCT	3
KRS18GTG	TATGAAATTGGTAAAGTATTTAGAAATGAAGGTATAGATAATACACATAATCCTGAATTTACTTCGGTGGAATTTTATTGGGCATATGCT	5
KRS18TCT	TATGAAATTGGTAAAGTATTTAGAAATGAAGGTATAGATAATACACATAATCCTGAATTTACTTCGTCTGAATTTTATTGGGCATATGCT	28
KRS18TCC	TATGAAATTGGTAAAGTATTTAGAAATGAAGGTATAGATAATACACATAATCCTGAATTTACTTCGTCCGAATTTTATTGGGCATATGCT	0
KRS18TCA	TATGAAATTGGTAAAGTATTTAGAAATGAAGGTATAGATAATACACATAATCCTGAATTTACTTCGTCAGAATTTTATTGGGCATATGCT	1
KRS18TCG	TATGAAATTGGTAAAGTATTTAGAAATGAAGGTATAGATAATACACATAATCCTGAATTTACTTCGTCGGAATTTTATTGGGCATATGCT	43
KRS18CCT	TATGAAATTGGTAAAGTATTTAGAAATGAAGGTATAGATAATACACATAATCCTGAATTTACTTCGCCTGAATTTTATTGGGCATATGCT	1
KRS18CCC	TATGAAATTGGTAAAGTATTTAGAAATGAAGGTATAGATAATACACATAATCCTGAATTTACTTCGCCCGAATTTTATTGGGCATATGCT	0
KRS18CCA	TATGAAATTGGTAAAGTATTTAGAAATGAAGGTATAGATAATACACATAATCCTGAATTTACTTCGCCAGAATTTTATTGGGCATATGCT	15
KRS18CCG	TATGAAATTGGTAAAGTATTTAGAAATGAAGGTATAGATAATACACATAATCCTGAATTTACTTCGCCGGAATTTTATTGGGCATATGCT	1
KRS18ACT	TATGAAATTGGTAAAGTATTTAGAAATGAAGGTATAGATAATACACATAATCCTGAATTTACTTCGACTGAATTTTATTGGGCATATGCT	0
KRS18ACC	TATGAAATTGGTAAAGTATTTAGAAATGAAGGTATAGATAATACACATAATCCTGAATTTACTTCGACCGAATTTTATTGGGCATATGCT	0
KRS18ACA	TATGAAATTGGTAAAGTATTTAGAAATGAAGGTATAGATAATACACATAATCCTGAATTTACTTCGACAGAATTTTATTGGGCATATGCT	4
KRS18ACG	TATGAAATTGGTAAAGTATTTAGAAATGAAGGTATAGATAATACACATAATCCTGAATTTACTTCGACGGAATTTTATTGGGCATATGCT	1
KRS18GCT	TATGAAATTGGTAAAGTATTTAGAAATGAAGGTATAGATAATACACATAATCCTGAATTTACTTCGGCTGAATTTTATTGGGCATATGCT	1
KRS18GCC	TATGAAATTGGTAAAGTATTTAGAAATGAAGGTATAGATAATACACATAATCCTGAATTTACTTCGGCCGAATTTTATTGGGCATATGCT	0
KRS18GCA	TATGAAATTGGTAAAGTATTTAGAAATGAAGGTATAGATAATACACATAATCCTGAATTTACTTCGGCAGAATTTTATTGGGCATATGCT	2
KRS18GCG	TATGAAATTGGTAAAGTATTTAGAAATGAAGGTATAGATAATACACATAATCCTGAATTTACTTCGGCGGAATTTTATTGGGCATATGCT	4
KRS18TAT	TATGAAATTGGTAAAGTATTTAGAAATGAAGGTATAGATAATACACATAATCCTGAATTTACTTCGTATGAATTTTATTGGGCATATGCT	28
KRS18TAC	TATGAAATTGGTAAAGTATTTAGAAATGAAGGTATAGATAATACACATAATCCTGAATTTACTTCGTACGAATTTTATTGGGCATATGCT	0
KRS18TAA	TATGAAATTGGTAAAGTATTTAGAAATGAAGGTATAGATAATACACATAATCCTGAATTTACTTCGTAAGAATTTTATTGGGCATATGCT	1
KRS18TAG	TATGAAATTGGTAAAGTATTTAGAAATGAAGGTATAGATAATACACATAATCCTGAATTTACTTCGTAGGAATTTTATTGGGCATATGCT	2
KRS18CAT	TATGAAATTGGTAAAGTATTTAGAAATGAAGGTATAGATAATACACATAATCCTGAATTTACTTCGCATGAATTTTATTGGGCATATGCT	2
KRS18CAC	TATGAAATTGGTAAAGTATTTAGAAATGAAGGTATAGATAATACACATAATCCTGAATTTACTTCGCACGAATTTTATTGGGCATATGCT	0
KRS18CAA	TATGAAATTGGTAAAGTATTTAGAAATGAAGGTATAGATAATACACATAATCCTGAATTTACTTCGCAAGAATTTTATTGGGCATATGCT	13
KRS18CAG	TATGAAATTGGTAAAGTATTTAGAAATGAAGGTATAGATAATACACATAATCCTGAATTTACTTCGCAGGAATTTTATTGGGCATATGCT	3
KRS18AAT	TATGAAATTGGTAAAGTATTTAGAAATGAAGGTATAGATAATACACATAATCCTGAATTTACTTCGAATGAATTTTATTGGGCATATGCT	8
KRS18AAC	TATGAAATTGGTAAAGTATTTAGAAATGAAGGTATAGATAATACACATAATCCTGAATTTACTTCGAACGAATTTTATTGGGCATATGCT	2
KRS18AAA	TATGAAATTGGTAAAGTATTTAGAAATGAAGGTATAGATAATACACATAATCCTGAATTTACTTCGAAAGAATTTTATTGGGCATATGCT	51
KRS18AAG	TATGAAATTGGTAAAGTATTTAGAAATGAAGGTATAGATAATACACATAATCCTGAATTTACTTCGAAGGAATTTTATTGGGCATATGCT	0
KRS18GAT	TATGAAATTGGTAAAGTATTTAGAAATGAAGGTATAGATAATACACATAATCCTGAATTTACTTCGGATGAATTTTATTGGGCATATGCT	9784
KRS18GAC	TATGAAATTGGTAAAGTATTTAGAAATGAAGGTATAGATAATACACATAATCCTGAATTTACTTCGGACGAATTTTATTGGGCATATGCT	11
KRS18GAA	TATGAAATTGGTAAAGTATTTAGAAATGAAGGTATAGATAATACACATAATCCTGAATTTACTTCGGAAGAATTTTATTGGGCATATGCT	11
KRS18GAG	TATGAAATTGGTAAAGTATTTAGAAATGAAGGTATAGATAATACACATAATCCTGAATTTACTTCGGAGGAATTTTATTGGGCATATGCT	2
KRS18TGT	TATGAAATTGGTAAAGTATTTAGAAATGAAGGTATAGATAATACACATAATCCTGAATTTACTTCGTGTGAATTTTATTGGGCATATGCT	40702
KRS18TGC	TATGAAATTGGTAAAGTATTTAGAAATGAAGGTATAGATAATACACATAATCCTGAATTTACTTCGTGCGAATTTTATTGGGCATATGCT	86
KRS18TGA	TATGAAATTGGTAAAGTATTTAGAAATGAAGGTATAGATAATACACATAATCCTGAATTTACTTCGTGAGAATTTTATTGGGCATATGCT	32
KRS18TGG	TATGAAATTGGTAAAGTATTTAGAAATGAAGGTATAGATAATACACATAATCCTGAATTTACTTCGTGGGAATTTTATTGGGCATATGCT	13
KRS18CGT	TATGAAATTGGTAAAGTATTTAGAAATGAAGGTATAGATAATACACATAATCCTGAATTTACTTCGCGTGAATTTTATTGGGCATATGCT	132
KRS18CGC	TATGAAATTGGTAAAGTATTTAGAAATGAAGGTATAGATAATACACATAATCCTGAATTTACTTCGCGCGAATTTTATTGGGCATATGCT	4
KRS18CGA	TATGAAATTGGTAAAGTATTTAGAAATGAAGGTATAGATAATACACATAATCCTGAATTTACTTCGCGAGAATTTTATTGGGCATATGCT	11451
KRS18CGG	TATGAAATTGGTAAAGTATTTAGAAATGAAGGTATAGATAATACACATAATCCTGAATTTACTTCGCGGGAATTTTATTGGGCATATGCT	23
KRS18AGT	TATGAAATTGGTAAAGTATTTAGAAATGAAGGTATAGATAATACACATAATCCTGAATTTACTTCGAGTGAATTTTATTGGGCATATGCT	20
KRS18AGC	TATGAAATTGGTAAAGTATTTAGAAATGAAGGTATAGATAATACACATAATCCTGAATTTACTTCGAGCGAATTTTATTGGGCATATGCT	0
KRS18AGA	TATGAAATTGGTAAAGTATTTAGAAATGAAGGTATAGATAATACACATAATCCTGAATTTACTTCGAGAGAATTTTATTGGGCATATGCT	5
KRS18AGG	TATGAAATTGGTAAAGTATTTAGAAATGAAGGTATAGATAATACACATAATCCTGAATTTACTTCGAGGGAATTTTATTGGGCATATGCT	0
KRS18GGT	TATGAAATTGGTAAAGTATTTAGAAATGAAGGTATAGATAATACACATAATCCTGAATTTACTTCGGGTGAATTTTATTGGGCATATGCT	29
KRS18GGC	TATGAAATTGGTAAAGTATTTAGAAATGAAGGTATAGATAATACACATAATCCTGAATTTACTTCGGGCGAATTTTATTGGGCATATGCT	0
KRS18GGA	TATGAAATTGGTAAAGTATTTAGAAATGAAGGTATAGATAATACACATAATCCTGAATTTACTTCGGGAGAATTTTATTGGGCATATGCT	26
KRS18GGG	TATGAAATTGGTAAAGTATTTAGAAATGAAGGTATAGATAATACACATAATCCTGAATTTACTTCGGGGGAATTTTATTGGGCATATGCT	0
KRS19TTT	TATGAAATTGGTAAAGTATTTAGAAATGAAGGTATAGATAATACACATAATCCTGAATTTACTTCGTGTTTTTTTTATTGGGCATATGCT	3
KRS19TTC	TATGAAATTGGTAAAGTATTTAGAAATGAAGGTATAGATAATACACATAATCCTGAATTTACTTCGTGTTTCTTTTATTGGGCATATGCT	2
KRS19TTA	TATGAAATTGGTAAAGTATTTAGAAATGAAGGTATAGATAATACACATAATCCTGAATTTACTTCGTGTTTATTTTATTGGGCATATGCT	5
KRS19TTG	TATGAAATTGGTAAAGTATTTAGAAATGAAGGTATAGATAATACACATAATCCTGAATTTACTTCGTGTTTGTTTTATTGGGCATATGCT	1
KRS19CTT	TATGAAATTGGTAAAGTATTTAGAAATGAAGGTATAGATAATACACATAATCCTGAATTTACTTCGTGTCTTTTTTATTGGGCATATGCT	2
KRS19CTC	TATGAAATTGGTAAAGTATTTAGAAATGAAGGTATAGATAATACACATAATCCTGAATTTACTTCGTGTCTCTTTTATTGGGCATATGCT	0
KRS19CTA	TATGAAATTGGTAAAGTATTTAGAAATGAAGGTATAGATAATACACATAATCCTGAATTTACTTCGTGTCTATTTTATTGGGCATATGCT	3
KRS19CTG	TATGAAATTGGTAAAGTATTTAGAAATGAAGGTATAGATAATACACATAATCCTGAATTTACTTCGTGTCTGTTTTATTGGGCATATGCT	1
KRS19ATT	TATGAAATTGGTAAAGTATTTAGAAATGAAGGTATAGATAATACACATAATCCTGAATTTACTTCGTGTATTTTTTATTGGGCATATGCT	1
KRS19ATC	TATGAAATTGGTAAAGTATTTAGAAATGAAGGTATAGATAATACACATAATCCTGAATTTACTTCGTGTATCTTTTATTGGGCATATGCT	0
KRS19ATA	TATGAAATTGGTAAAGTATTTAGAAATGAAGGTATAGATAATACACATAATCCTGAATTTACTTCGTGTATATTTTATTGGGCATATGCT	252
KRS19ATG	TATGAAATTGGTAAAGTATTTAGAAATGAAGGTATAGATAATACACATAATCCTGAATTTACTTCGTGTATGTTTTATTGGGCATATGCT	2
KRS19GTT	TATGAAATTGGTAAAGTATTTAGAAATGAAGGTATAGATAATACACATAATCCTGAATTTACTTCGTGTGTTTTTTATTGGGCATATGCT	3
KRS19GTC	TATGAAATTGGTAAAGTATTTAGAAATGAAGGTATAGATAATACACATAATCCTGAATTTACTTCGTGTGTCTTTTATTGGGCATATGCT	1
KRS19GTA	TATGAAATTGGTAAAGTATTTAGAAATGAAGGTATAGATAATACACATAATCCTGAATTTACTTCGTGTGTATTTTATTGGGCATATGCT	49
KRS19GTG	TATGAAATTGGTAAAGTATTTAGAAATGAAGGTATAGATAATACACATAATCCTGAATTTACTTCGTGTGTGTTTTATTGGGCATATGCT	2
KRS19TCT	TATGAAATTGGTAAAGTATTTAGAAATGAAGGTATAGATAATACACATAATCCTGAATTTACTTCGTGTTCTTTTTATTGGGCATATGCT	0
KRS19TCC	TATGAAATTGGTAAAGTATTTAGAAATGAAGGTATAGATAATACACATAATCCTGAATTTACTTCGTGTTCCTTTTATTGGGCATATGCT	1
KRS19TCA	TATGAAATTGGTAAAGTATTTAGAAATGAAGGTATAGATAATACACATAATCCTGAATTTACTTCGTGTTCATTTTATTGGGCATATGCT	3
KRS19TCG	TATGAAATTGGTAAAGTATTTAGAAATGAAGGTATAGATAATACACATAATCCTGAATTTACTTCGTGTTCGTTTTATTGGGCATATGCT	5
KRS19CCT	TATGAAATTGGTAAAGTATTTAGAAATGAAGGTATAGATAATACACATAATCCTGAATTTACTTCGTGTCCTTTTTATTGGGCATATGCT	0
KRS19CCC	TATGAAATTGGTAAAGTATTTAGAAATGAAGGTATAGATAATACACATAATCCTGAATTTACTTCGTGTCCCTTTTATTGGGCATATGCT	1
KRS19CCA	TATGAAATTGGTAAAGTATTTAGAAATGAAGGTATAGATAATACACATAATCCTGAATTTACTTCGTGTCCATTTTATTGGGCATATGCT	1
KRS19CCG	TATGAAATTGGTAAAGTATTTAGAAATGAAGGTATAGATAATACACATAATCCTGAATTTACTTCGTGTCCGTTTTATTGGGCATATGCT	0
KRS19ACT	TATGAAATTGGTAAAGTATTTAGAAATGAAGGTATAGATAATACACATAATCCTGAATTTACTTCGTGTACTTTTTATTGGGCATATGCT	1
KRS19ACC	TATGAAATTGGTAAAGTATTTAGAAATGAAGGTATAGATAATACACATAATCCTGAATTTACTTCGTGTACCTTTTATTGGGCATATGCT	1
KRS19ACA	TATGAAATTGGTAAAGTATTTAGAAATGAAGGTATAGATAATACACATAATCCTGAATTTACTTCGTGTACATTTTATTGGGCATATGCT	5
KRS19ACG	TATGAAATTGGTAAAGTATTTAGAAATGAAGGTATAGATAATACACATAATCCTGAATTTACTTCGTGTACGTTTTATTGGGCATATGCT	0
KRS19GCT	TATGAAATTGGTAAAGTATTTAGAAATGAAGGTATAGATAATACACATAATCCTGAATTTACTTCGTGTGCTTTTTATTGGGCATATGCT	0
KRS19GCC	TATGAAATTGGTAAAGTATTTAGAAATGAAGGTATAGATAATACACATAATCCTGAATTTACTTCGTGTGCCTTTTATTGGGCATATGCT	0
KRS19GCA	TATGAAATTGGTAAAGTATTTAGAAATGAAGGTATAGATAATACACATAATCCTGAATTTACTTCGTGTGCATTTTATTGGGCATATGCT	12
KRS19GCG	TATGAAATTGGTAAAGTATTTAGAAATGAAGGTATAGATAATACACATAATCCTGAATTTACTTCGTGTGCGTTTTATTGGGCATATGCT	2
KRS19TAT	TATGAAATTGGTAAAGTATTTAGAAATGAAGGTATAGATAATACACATAATCCTGAATTTACTTCGTGTTATTTTTATTGGGCATATGCT	4
KRS19TAC	TATGAAATTGGTAAAGTATTTAGAAATGAAGGTATAGATAATACACATAATCCTGAATTTACTTCGTGTTACTTTTATTGGGCATATGCT	2
KRS19TAA	TATGAAATTGGTAAAGTATTTAGAAATGAAGGTATAGATAATACACATAATCCTGAATTTACTTCGTGTTAATTTTATTGGGCATATGCT	9
KRS19TAG	TATGAAATTGGTAAAGTATTTAGAAATGAAGGTATAGATAATACACATAATCCTGAATTTACTTCGTGTTAGTTTTATTGGGCATATGCT	2
KRS19CAT	TATGAAATTGGTAAAGTATTTAGAAATGAAGGTATAGATAATACACATAATCCTGAATTTACTTCGTGTCATTTTTATTGGGCATATGCT	5
KRS19CAC	TATGAAATTGGTAAAGTATTTAGAAATGAAGGTATAGATAATACACATAATCCTGAATTTACTTCGTGTCACTTTTATTGGGCATATGCT	2
KRS19CAA	TATGAAATTGGTAAAGTATTTAGAAATGAAGGTATAGATAATACACATAATCCTGAATTTACTTCGTGTCAATTTTATTGGGCATATGCT	22
KRS19CAG	TATGAAATTGGTAAAGTATTTAGAAATGAAGGTATAGATAATACACATAATCCTGAATTTACTTCGTGTCAGTTTTATTGGGCATATGCT	3
KRS19AAT	TATGAAATTGGTAAAGTATTTAGAAATGAAGGTATAGATAATACACATAATCCTGAATTTACTTCGTGTAATTTTTATTGGGCATATGCT	3
KRS19AAC	TATGAAATTGGTAAAGTATTTAGAAATGAAGGTATAGATAATACACATAATCCTGAATTTACTTCGTGTAACTTTTATTGGGCATATGCT	2
KRS19AAA	TATGAAATTGGTAAAGTATTTAGAAATGAAGGTATAGATAATACACATAATCCTGAATTTACTTCGTGTAAATTTTATTGGGCATATGCT	50
KRS19AAG	TATGAAATTGGTAAAGTATTTAGAAATGAAGGTATAGATAATACACATAATCCTGAATTTACTTCGTGTAAGTTTTATTGGGCATATGCT	5
KRS19GAT	TATGAAATTGGTAAAGTATTTAGAAATGAAGGTATAGATAATACACATAATCCTGAATTTACTTCGTGTGATTTTTATTGGGCATATGCT	19
KRS19GAC	TATGAAATTGGTAAAGTATTTAGAAATGAAGGTATAGATAATACACATAATCCTGAATTTACTTCGTGTGACTTTTATTGGGCATATGCT	8
KRS19GAA	TATGAAATTGGTAAAGTATTTAGAAATGAAGGTATAGATAATACACATAATCCTGAATTTACTTCGTGTGAATTTTATTGGGCATATGCT	40702
KRS19GAG	TATGAAATTGGTAAAGTATTTAGAAATGAAGGTATAGATAATACACATAATCCTGAATTTACTTCGTGTGAGTTTTATTGGGCATATGCT	54
KRS19TGT	TATGAAATTGGTAAAGTATTTAGAAATGAAGGTATAGATAATACACATAATCCTGAATTTACTTCGTGTTGTTTTTATTGGGCATATGCT	3
KRS19TGC	TATGAAATTGGTAAAGTATTTAGAAATGAAGGTATAGATAATACACATAATCCTGAATTTACTTCGTGTTGCTTTTATTGGGCATATGCT	1
KRS19TGA	TATGAAATTGGTAAAGTATTTAGAAATGAAGGTATAGATAATACACATAATCCTGAATTTACTTCGTGTTGATTTTATTGGGCATATGCT	3
KRS19TGG	TATGAAATTGGTAAAGTATTTAGAAATGAAGGTATAGATAATACACATAATCCTGAATTTACTTCGTGTTGGTTTTATTGGGCATATGCT	1
KRS19CGT	TATGAAATTGGTAAAGTATTTAGAAATGAAGGTATAGATAATACACATAATCCTGAATTTACTTCGTGTCGTTTTTATTGGGCATATGCT	2
KRS19CGC	TATGAAATTGGTAAAGTATTTAGAAATGAAGGTATAGATAATACACATAATCCTGAATTTACTTCGTGTCGCTTTTATTGGGCATATGCT	1
KRS19CGA	TATGAAATTGGTAAAGTATTTAGAAATGAAGGTATAGATAATACACATAATCCTGAATTTACTTCGTGTCGATTTTATTGGGCATATGCT	1
KRS19CGG	TATGAAATTGGTAAAGTATTTAGAAATGAAGGTATAGATAATACACATAATCCTGAATTTACTTCGTGTCGGTTTTATTGGGCATATGCT	0
KRS19AGT	TATGAAATTGGTAAAGTATTTAGAAATGAAGGTATAGATAATACACATAATCCTGAATTTACTTCGTGTAGTTTTTATTGGGCATATGCT	4
KRS19AGC	TATGAAATTGGTAAAGTATTTAGAAATGAAGGTATAGATAATACACATAATCCTGAATTTACTTCGTGTAGCTTTTATTGGGCATATGCT	0
KRS19AGA	TATGAAATTGGTAAAGTATTTAGAAATGAAGGTATAGATAATACACATAATCCTGAATTTACTTCGTGTAGATTTTATTGGGCATATGCT	2
KRS19AGG	TATGAAATTGGTAAAGTATTTAGAAATGAAGGTATAGATAATACACATAATCCTGAATTTACTTCGTGTAGGTTTTATTGGGCATATGCT	0
KRS19GGT	TATGAAATTGGTAAAGTATTTAGAAATGAAGGTATAGATAATACACATAATCCTGAATTTACTTCGTGTGGTTTTTATTGGGCATATGCT	0
KRS19GGC	TATGAAATTGGTAAAGTATTTAGAAATGAAGGTATAGATAATACACATAATCCTGAATTTACTTCGTGTGGCTTTTATTGGGCATATGCT	0
KRS19GGA	TATGAAATTGGTAAAGTATTTAGAAATGAAGGTATAGATAATACACATAATCCTGAATTTACTTCGTGTGGATTTTATTGGGCATATGCT	98
KRS19GGG	TATGAAATTGGTAAAGTATTTAGAAATGAAGGTATAGATAATACACATAATCCTGAATTTACTTCGTGTGGGTTTTATTGGGCATATGCT	1
KRS20TTT	TATGAAATTGGTAAAGTATTTAGAAATGAAGGTATAGATAATACACATAATCCTGAATTTACTTCGTGTGAATTTTATTGGGCATATGCT	40702
KRS20TTC	TATGAAATTGGTAAAGTATTTAGAAATGAAGGTATAGATAATACACATAATCCTGAATTTACTTCGTGTGAATTCTATTGGGCATATGCT	52
KRS20TTA	TATGAAATTGGTAAAGTATTTAGAAATGAAGGTATAGATAATACACATAATCCTGAATTTACTTCGTGTGAATTATATTGGGCATATGCT	24
KRS20TTG	TATGAAATTGGTAAAGTATTTAGAAATGAAGGTATAGATAATACACATAATCCTGAATTTACTTCGTGTGAATTGTATTGGGCATATGCT	20
KRS20CTT	TATGAAATTGGTAAAGTATTTAGAAATGAAGGTATAGATAATACACATAATCCTGAATTTACTTCGTGTGAACTTTATTGGGCATATGCT	58
KRS20CTC	TATGAAATTGGTAAAGTATTTAGAAATGAAGGTATAGATAATACACATAATCCTGAATTTACTTCGTGTGAACTCTATTGGGCATATGCT	0
KRS20CTA	TATGAAATTGGTAAAGTATTTAGAAATGAAGGTATAGATAATACACATAATCCTGAATTTACTTCGTGTGAACTATATTGGGCATATGCT	0
KRS20CTG	TATGAAATTGGTAAAGTATTTAGAAATGAAGGTATAGATAATACACATAATCCTGAATTTACTTCGTGTGAACTGTATTGGGCATATGCT	11
KRS20ATT	TATGAAATTGGTAAAGTATTTAGAAATGAAGGTATAGATAATACACATAATCCTGAATTTACTTCGTGTGAAATTTATTGGGCATATGCT	40
KRS20ATC	TATGAAATTGGTAAAGTATTTAGAAATGAAGGTATAGATAATACACATAATCCTGAATTTACTTCGTGTGAAATCTATTGGGCATATGCT	2
KRS20ATA	TATGAAATTGGTAAAGTATTTAGAAATGAAGGTATAGATAATACACATAATCCTGAATTTACTTCGTGTGAAATATATTGGGCATATGCT	4
KRS20ATG	TATGAAATTGGTAAAGTATTTAGAAATGAAGGTATAGATAATACACATAATCCTGAATTTACTTCGTGTGAAATGTATTGGGCATATGCT	1
KRS20GTT	TATGAAATTGGTAAAGTATTTAGAAATGAAGGTATAGATAATACACATAATCCTGAATTTACTTCGTGTGAAGTTTATTGGGCATATGCT	7
KRS20GTC	TATGAAATTGGTAAAGTATTTAGAAATGAAGGTATAGATAATACACATAATCCTGAATTTACTTCGTGTGAAGTCTATTGGGCATATGCT	1
KRS20GTA	TATGAAATTGGTAAAGTATTTAGAAATGAAGGTATAGATAATACACATAATCCTGAATTTACTTCGTGTGAAGTATATTGGGCATATGCT	5
KRS20GTG	TATGAAATTGGTAAAGTATTTAGAAATGAAGGTATAGATAATACACATAATCCTGAATTTACTTCGTGTGAAGTGTATTGGGCATATGCT	0
KRS20TCT	TATGAAATTGGTAAAGTATTTAGAAATGAAGGTATAGATAATACACATAATCCTGAATTTACTTCGTGTGAATCTTATTGGGCATATGCT	74
KRS20TCC	TATGAAATTGGTAAAGTATTTAGAAATGAAGGTATAGATAATACACATAATCCTGAATTTACTTCGTGTGAATCCTATTGGGCATATGCT	2
KRS20TCA	TATGAAATTGGTAAAGTATTTAGAAATGAAGGTATAGATAATACACATAATCCTGAATTTACTTCGTGTGAATCATATTGGGCATATGCT	2
KRS20TCG	TATGAAATTGGTAAAGTATTTAGAAATGAAGGTATAGATAATACACATAATCCTGAATTTACTTCGTGTGAATCGTATTGGGCATATGCT	2
KRS20CCT	TATGAAATTGGTAAAGTATTTAGAAATGAAGGTATAGATAATACACATAATCCTGAATTTACTTCGTGTGAACCTTATTGGGCATATGCT	3
KRS20CCC	TATGAAATTGGTAAAGTATTTAGAAATGAAGGTATAGATAATACACATAATCCTGAATTTACTTCGTGTGAACCCTATTGGGCATATGCT	1
KRS20CCA	TATGAAATTGGTAAAGTATTTAGAAATGAAGGTATAGATAATACACATAATCCTGAATTTACTTCGTGTGAACCATATTGGGCATATGCT	1
KRS20CCG	TATGAAATTGGTAAAGTATTTAGAAATGAAGGTATAGATAATACACATAATCCTGAATTTACTTCGTGTGAACCGTATTGGGCATATGCT	1
KRS20ACT	TATGAAATTGGTAAAGTATTTAGAAATGAAGGTATAGATAATACACATAATCCTGAATTTACTTCGTGTGAAACTTATTGGGCATATGCT	0
KRS20ACC	TATGAAATTGGTAAAGTATTTAGAAATGAAGGTATAGATAATACACATAATCCTGAATTTACTTCGTGTGAAACCTATTGGGCATATGCT	0
KRS20ACA	TATGAAATTGGTAAAGTATTTAGAAATGAAGGTATAGATAATACACATAATCCTGAATTTACTTCGTGTGAAACATATTGGGCATATGCT	210
KRS20ACG	TATGAAATTGGTAAAGTATTTAGAAATGAAGGTATAGATAATACACATAATCCTGAATTTACTTCGTGTGAAACGTATTGGGCATATGCT	4
KRS20GCT	TATGAAATTGGTAAAGTATTTAGAAATGAAGGTATAGATAATACACATAATCCTGAATTTACTTCGTGTGAAGCTTATTGGGCATATGCT	0
KRS20GCC	TATGAAATTGGTAAAGTATTTAGAAATGAAGGTATAGATAATACACATAATCCTGAATTTACTTCGTGTGAAGCCTATTGGGCATATGCT	0
KRS20GCA	TATGAAATTGGTAAAGTATTTAGAAATGAAGGTATAGATAATACACATAATCCTGAATTTACTTCGTGTGAAGCATATTGGGCATATGCT	1
KRS20GCG	TATGAAATTGGTAAAGTATTTAGAAATGAAGGTATAGATAATACACATAATCCTGAATTTACTTCGTGTGAAGCGTATTGGGCATATGCT	1
KRS20TAT	TATGAAATTGGTAAAGTATTTAGAAATGAAGGTATAGATAATACACATAATCCTGAATTTACTTCGTGTGAATATTATTGGGCATATGCT	18
KRS20TAC	TATGAAATTGGTAAAGTATTTAGAAATGAAGGTATAGATAATACACATAATCCTGAATTTACTTCGTGTGAATACTATTGGGCATATGCT	6
KRS20TAA	TATGAAATTGGTAAAGTATTTAGAAATGAAGGTATAGATAATACACATAATCCTGAATTTACTTCGTGTGAATAATATTGGGCATATGCT	236
KRS20TAG	TATGAAATTGGTAAAGTATTTAGAAATGAAGGTATAGATAATACACATAATCCTGAATTTACTTCGTGTGAATAGTATTGGGCATATGCT	1
KRS20CAT	TATGAAATTGGTAAAGTATTTAGAAATGAAGGTATAGATAATACACATAATCCTGAATTTACTTCGTGTGAACATTATTGGGCATATGCT	9
KRS20CAC	TATGAAATTGGTAAAGTATTTAGAAATGAAGGTATAGATAATACACATAATCCTGAATTTACTTCGTGTGAACACTATTGGGCATATGCT	3
KRS20CAA	TATGAAATTGGTAAAGTATTTAGAAATGAAGGTATAGATAATACACATAATCCTGAATTTACTTCGTGTGAACAATATTGGGCATATGCT	4
KRS20CAG	TATGAAATTGGTAAAGTATTTAGAAATGAAGGTATAGATAATACACATAATCCTGAATTTACTTCGTGTGAACAGTATTGGGCATATGCT	2
KRS20AAT	TATGAAATTGGTAAAGTATTTAGAAATGAAGGTATAGATAATACACATAATCCTGAATTTACTTCGTGTGAAAATTATTGGGCATATGCT	12
KRS20AAC	TATGAAATTGGTAAAGTATTTAGAAATGAAGGTATAGATAATACACATAATCCTGAATTTACTTCGTGTGAAAACTATTGGGCATATGCT	2
KRS20AAA	TATGAAATTGGTAAAGTATTTAGAAATGAAGGTATAGATAATACACATAATCCTGAATTTACTTCGTGTGAAAAATATTGGGCATATGCT	29
KRS20AAG	TATGAAATTGGTAAAGTATTTAGAAATGAAGGTATAGATAATACACATAATCCTGAATTTACTTCGTGTGAAAAGTATTGGGCATATGCT	3
KRS20GAT	TATGAAATTGGTAAAGTATTTAGAAATGAAGGTATAGATAATACACATAATCCTGAATTTACTTCGTGTGAAGATTATTGGGCATATGCT	1
KRS20GAC	TATGAAATTGGTAAAGTATTTAGAAATGAAGGTATAGATAATACACATAATCCTGAATTTACTTCGTGTGAAGACTATTGGGCATATGCT	1
KRS20GAA	TATGAAATTGGTAAAGTATTTAGAAATGAAGGTATAGATAATACACATAATCCTGAATTTACTTCGTGTGAAGAATATTGGGCATATGCT	0
KRS20GAG	TATGAAATTGGTAAAGTATTTAGAAATGAAGGTATAGATAATACACATAATCCTGAATTTACTTCGTGTGAAGAGTATTGGGCATATGCT	2
KRS20TGT	TATGAAATTGGTAAAGTATTTAGAAATGAAGGTATAGATAATACACATAATCCTGAATTTACTTCGTGTGAATGTTATTGGGCATATGCT	12
KRS20TGC	TATGAAATTGGTAAAGTATTTAGAAATGAAGGTATAGATAATACACATAATCCTGAATTTACTTCGTGTGAATGCTATTGGGCATATGCT	3
KRS20TGA	TATGAAATTGGTAAAGTATTTAGAAATGAAGGTATAGATAATACACATAATCCTGAATTTACTTCGTGTGAATGATATTGGGCATATGCT	3
KRS20TGG	TATGAAATTGGTAAAGTATTTAGAAATGAAGGTATAGATAATACACATAATCCTGAATTTACTTCGTGTGAATGGTATTGGGCATATGCT	8
KRS20CGT	TATGAAATTGGTAAAGTATTTAGAAATGAAGGTATAGATAATACACATAATCCTGAATTTACTTCGTGTGAACGTTATTGGGCATATGCT	2
KRS20CGC	TATGAAATTGGTAAAGTATTTAGAAATGAAGGTATAGATAATACACATAATCCTGAATTTACTTCGTGTGAACGCTATTGGGCATATGCT	2
KRS20CGA	TATGAAATTGGTAAAGTATTTAGAAATGAAGGTATAGATAATACACATAATCCTGAATTTACTTCGTGTGAACGATATTGGGCATATGCT	3
KRS20CGG	TATGAAATTGGTAAAGTATTTAGAAATGAAGGTATAGATAATACACATAATCCTGAATTTACTTCGTGTGAACGGTATTGGGCATATGCT	1
KRS20AGT	TATGAAATTGGTAAAGTATTTAGAAATGAAGGTATAGATAATACACATAATCCTGAATTTACTTCGTGTGAAAGTTATTGGGCATATGCT	3
KRS20AGC	TATGAAATTGGTAAAGTATTTAGAAATGAAGGTATAGATAATACACATAATCCTGAATTTACTTCGTGTGAAAGCTATTGGGCATATGCT	0
KRS20AGA	TATGAAATTGGTAAAGTATTTAGAAATGAAGGTATAGATAATACACATAATCCTGAATTTACTTCGTGTGAAAGATATTGGGCATATGCT	8
KRS20AGG	TATGAAATTGGTAAAGTATTTAGAAATGAAGGTATAGATAATACACATAATCCTGAATTTACTTCGTGTGAAAGGTATTGGGCATATGCT	1
KRS20GGT	TATGAAATTGGTAAAGTATTTAGAAATGAAGGTATAGATAATACACATAATCCTGAATTTACTTCGTGTGAAGGTTATTGGGCATATGCT	3
KRS20GGC	TATGAAATTGGTAAAGTATTTAGAAATGAAGGTATAGATAATACACATAATCCTGAATTTACTTCGTGTGAAGGCTATTGGGCATATGCT	7
KRS20GGA	TATGAAATTGGTAAAGTATTTAGAAATGAAGGTATAGATAATACACATAATCCTGAATTTACTTCGTGTGAAGGATATTGGGCATATGCT	2
KRS20GGG	TATGAAATTGGTAAAGTATTTAGAAATGAAGGTATAGATAATACACATAATCCTGAATTTACTTCGTGTGAAGGGTATTGGGCATATGCT	0
KRS_1TTT	TATGAAATTGGTTTTGTATTTAGAAATGAAGGTATAGATAATACACATAATCCTGAATTTACTTCGTGTGAATTTTATTGGGCATATGCT	0
KRS_1TTC	TATGAAATTGGTTTCGTATTTAGAAATGAAGGTATAGATAATACACATAATCCTGAATTTACTTCGTGTGAATTTTATTGGGCATATGCT	0
KRS_1TTA	TATGAAATTGGTTTAGTATTTAGAAATGAAGGTATAGATAATACACATAATCCTGAATTTACTTCGTGTGAATTTTATTGGGCATATGCT	1
KRS_1TTG	TATGAAATTGGTTTGGTATTTAGAAATGAAGGTATAGATAATACACATAATCCTGAATTTACTTCGTGTGAATTTTATTGGGCATATGCT	0
KRS_1CTT	TATGAAATTGGTCTTGTATTTAGAAATGAAGGTATAGATAATACACATAATCCTGAATTTACTTCGTGTGAATTTTATTGGGCATATGCT	0
KRS_1CTC	TATGAAATTGGTCTCGTATTTAGAAATGAAGGTATAGATAATACACATAATCCTGAATTTACTTCGTGTGAATTTTATTGGGCATATGCT	0
KRS_1CTA	TATGAAATTGGTCTAGTATTTAGAAATGAAGGTATAGATAATACACATAATCCTGAATTTACTTCGTGTGAATTTTATTGGGCATATGCT	0
KRS_1CTG	TATGAAATTGGTCTGGTATTTAGAAATGAAGGTATAGATAATACACATAATCCTGAATTTACTTCGTGTGAATTTTATTGGGCATATGCT	0
KRS_1ATT	TATGAAATTGGTATTGTATTTAGAAATGAAGGTATAGATAATACACATAATCCTGAATTTACTTCGTGTGAATTTTATTGGGCATATGCT	0
KRS_1ATC	TATGAAATTGGTATCGTATTTAGAAATGAAGGTATAGATAATACACATAATCCTGAATTTACTTCGTGTGAATTTTATTGGGCATATGCT	0
KRS_1ATA	TATGAAATTGGTATAGTATTTAGAAATGAAGGTATAGATAATACACATAATCCTGAATTTACTTCGTGTGAATTTTATTGGGCATATGCT	34
KRS_1ATG	TATGAAATTGGTATGGTATTTAGAAATGAAGGTATAGATAATACACATAATCCTGAATTTACTTCGTGTGAATTTTATTGGGCATATGCT	0
KRS_1GTT	TATGAAATTGGTGTTGTATTTAGAAATGAAGGTATAGATAATACACATAATCCTGAATTTACTTCGTGTGAATTTTATTGGGCATATGCT	0
KRS_1GTC	TATGAAATTGGTGTCGTATTTAGAAATGAAGGTATAGATAATACACATAATCCTGAATTTACTTCGTGTGAATTTTATTGGGCATATGCT	0
KRS_1GTA	TATGAAATTGGTGTAGTATTTAGAAATGAAGGTATAGATAATACACATAATCCTGAATTTACTTCGTGTGAATTTTATTGGGCATATGCT	0
KRS_1GTG	TATGAAATTGGTGTGGTATTTAGAAATGAAGGTATAGATAATACACATAATCCTGAATTTACTTCGTGTGAATTTTATTGGGCATATGCT	0
KRS_1TCT	TATGAAATTGGTTCTGTATTTAGAAATGAAGGTATAGATAATACACATAATCCTGAATTTACTTCGTGTGAATTTTATTGGGCATATGCT	0
KRS_1TCC	TATGAAATTGGTTCCGTATTTAGAAATGAAGGTATAGATAATACACATAATCCTGAATTTACTTCGTGTGAATTTTATTGGGCATATGCT	0
KRS_1TCA	TATGAAATTGGTTCAGTATTTAGAAATGAAGGTATAGATAATACACATAATCCTGAATTTACTTCGTGTGAATTTTATTGGGCATATGCT	0
KRS_1TCG	TATGAAATTGGTTCGGTATTTAGAAATGAAGGTATAGATAATACACATAATCCTGAATTTACTTCGTGTGAATTTTATTGGGCATATGCT	0
KRS_1CCT	TATGAAATTGGTCCTGTATTTAGAAATGAAGGTATAGATAATACACATAATCCTGAATTTACTTCGTGTGAATTTTATTGGGCATATGCT	0
KRS_1CCC	TATGAAATTGGTCCCGTATTTAGAAATGAAGGTATAGATAATACACATAATCCTGAATTTACTTCGTGTGAATTTTATTGGGCATATGCT	0
KRS_1CCA	TATGAAATTGGTCCAGTATTTAGAAATGAAGGTATAGATAATACACATAATCCTGAATTTACTTCGTGTGAATTTTATTGGGCATATGCT	0
KRS_1CCG	TATGAAATTGGTCCGGTATTTAGAAATGAAGGTATAGATAATACACATAATCCTGAATTTACTTCGTGTGAATTTTATTGGGCATATGCT	0
KRS_1ACT	TATGAAATTGGTACTGTATTTAGAAATGAAGGTATAGATAATACACATAATCCTGAATTTACTTCGTGTGAATTTTATTGGGCATATGCT	0
KRS_1ACC	TATGAAATTGGTACCGTATTTAGAAATGAAGGTATAGATAATACACATAATCCTGAATTTACTTCGTGTGAATTTTATTGGGCATATGCT	0
KRS_1ACA	TATGAAATTGGTACAGTATTTAGAAATGAAGGTATAGATAATACACATAATCCTGAATTTACTTCGTGTGAATTTTATTGGGCATATGCT	8
KRS_1ACG	TATGAAATTGGTACGGTATTTAGAAATGAAGGTATAGATAATACACATAATCCTGAATTTACTTCGTGTGAATTTTATTGGGCATATGCT	0
KRS_1GCT	TATGAAATTGGTGCTGTATTTAGAAATGAAGGTATAGATAATACACATAATCCTGAATTTACTTCGTGTGAATTTTATTGGGCATATGCT	0
KRS_1GCC	TATGAAATTGGTGCCGTATTTAGAAATGAAGGTATAGATAATACACATAATCCTGAATTTACTTCGTGTGAATTTTATTGGGCATATGCT	0
KRS_1GCA	TATGAAATTGGTGCAGTATTTAGAAATGAAGGTATAGATAATACACATAATCCTGAATTTACTTCGTGTGAATTTTATTGGGCATATGCT	0
KRS_1GCG	TATGAAATTGGTGCGGTATTTAGAAATGAAGGTATAGATAATACACATAATCCTGAATTTACTTCGTGTGAATTTTATTGGGCATATGCT	0
KRS_1TAT	TATGAAATTGGTTATGTATTTAGAAATGAAGGTATAGATAATACACATAATCCTGAATTTACTTCGTGTGAATTTTATTGGGCATATGCT	1
KRS_1TAC	TATGAAATTGGTTACGTATTTAGAAATGAAGGTATAGATAATACACATAATCCTGAATTTACTTCGTGTGAATTTTATTGGGCATATGCT	0
KRS_1TAA	TATGAAATTGGTTAAGTATTTAGAAATGAAGGTATAGATAATACACATAATCCTGAATTTACTTCGTGTGAATTTTATTGGGCATATGCT	28
KRS_1TAG	TATGAAATTGGTTAGGTATTTAGAAATGAAGGTATAGATAATACACATAATCCTGAATTTACTTCGTGTGAATTTTATTGGGCATATGCT	0
KRS_1CAT	TATGAAATTGGTCATGTATTTAGAAATGAAGGTATAGATAATACACATAATCCTGAATTTACTTCGTGTGAATTTTATTGGGCATATGCT	0
KRS_1CAC	TATGAAATTGGTCACGTATTTAGAAATGAAGGTATAGATAATACACATAATCCTGAATTTACTTCGTGTGAATTTTATTGGGCATATGCT	0
KRS_1CAA	TATGAAATTGGTCAAGTATTTAGAAATGAAGGTATAGATAATACACATAATCCTGAATTTACTTCGTGTGAATTTTATTGGGCATATGCT	8
KRS_1CAG	TATGAAATTGGTCAGGTATTTAGAAATGAAGGTATAGATAATACACATAATCCTGAATTTACTTCGTGTGAATTTTATTGGGCATATGCT	0
KRS_1AAT	TATGAAATTGGTAATGTATTTAGAAATGAAGGTATAGATAATACACATAATCCTGAATTTACTTCGTGTGAATTTTATTGGGCATATGCT	19
KRS_1AAC	TATGAAATTGGTAACGTATTTAGAAATGAAGGTATAGATAATACACATAATCCTGAATTTACTTCGTGTGAATTTTATTGGGCATATGCT	6
KRS_1AAA	TATGAAATTGGTAAAGTATTTAGAAATGAAGGTATAGATAATACACATAATCCTGAATTTACTTCGTGTGAATTTTATTGGGCATATGCT	40702
KRS_1AAG	TATGAAATTGGTAAGGTATTTAGAAATGAAGGTATAGATAATACACATAATCCTGAATTTACTTCGTGTGAATTTTATTGGGCATATGCT	112
KRS_1GAT	TATGAAATTGGTGATGTATTTAGAAATGAAGGTATAGATAATACACATAATCCTGAATTTACTTCGTGTGAATTTTATTGGGCATATGCT	0
KRS_1GAC	TATGAAATTGGTGACGTATTTAGAAATGAAGGTATAGATAATACACATAATCCTGAATTTACTTCGTGTGAATTTTATTGGGCATATGCT	0
KRS_1GAA	TATGAAATTGGTGAAGTATTTAGAAATGAAGGTATAGATAATACACATAATCCTGAATTTACTTCGTGTGAATTTTATTGGGCATATGCT	69
KRS_1GAG	TATGAAATTGGTGAGGTATTTAGAAATGAAGGTATAGATAATACACATAATCCTGAATTTACTTCGTGTGAATTTTATTGGGCATATGCT	0
KRS_1TGT	TATGAAATTGGTTGTGTATTTAGAAATGAAGGTATAGATAATACACATAATCCTGAATTTACTTCGTGTGAATTTTATTGGGCATATGCT	0
KRS_1TGC	TATGAAATTGGTTGCGTATTTAGAAATGAAGGTATAGATAATACACATAATCCTGAATTTACTTCGTGTGAATTTTATTGGGCATATGCT	0
KRS_1TGA	TATGAAATTGGTTGAGTATTTAGAAATGAAGGTATAGATAATACACATAATCCTGAATTTACTTCGTGTGAATTTTATTGGGCATATGCT	0
KRS_1TGG	TATGAAATTGGTTGGGTATTTAGAAATGAAGGTATAGATAATACACATAATCCTGAATTTACTTCGTGTGAATTTTATTGGGCATATGCT	0
KRS_1CGT	TATGAAATTGGTCGTGTATTTAGAAATGAAGGTATAGATAATACACATAATCCTGAATTTACTTCGTGTGAATTTTATTGGGCATATGCT	0
KRS_1CGC	TATGAAATTGGTCGCGTATTTAGAAATGAAGGTATAGATAATACACATAATCCTGAATTTACTTCGTGTGAATTTTATTGGGCATATGCT	0
KRS_1CGA	TATGAAATTGGTCGAGTATTTAGAAATGAAGGTATAGATAATACACATAATCCTGAATTTACTTCGTGTGAATTTTATTGGGCATATGCT	0
KRS_1CGG	TATGAAATTGGTCGGGTATTTAGAAATGAAGGTATAGATAATACACATAATCCTGAATTTACTTCGTGTGAATTTTATTGGGCATATGCT	0
KRS_1AGT	TATGAAATTGGTAGTGTATTTAGAAATGAAGGTATAGATAATACACATAATCCTGAATTTACTTCGTGTGAATTTTATTGGGCATATGCT	0
KRS_1AGC	TATGAAATTGGTAGCGTATTTAGAAATGAAGGTATAGATAATACACATAATCCTGAATTTACTTCGTGTGAATTTTATTGGGCATATGCT	0
KRS_1AGA	TATGAAATTGGTAGAGTATTTAGAAATGAAGGTATAGATAATACACATAATCCTGAATTTACTTCGTGTGAATTTTATTGGGCATATGCT	125
KRS_1AGG	TATGAAATTGGTAGGGTATTTAGAAATGAAGGTATAGATAATACACATAATCCTGAATTTACTTCGTGTGAATTTTATTGGGCATATGCT	0
KRS_1GGT	TATGAAATTGGTGGTGTATTTAGAAATGAAGGTATAGATAATACACATAATCCTGAATTTACTTCGTGTGAATTTTATTGGGCATATGCT	0
KRS_1GGC	TATGAAATTGGTGGCGTATTTAGAAATGAAGGTATAGATAATACACATAATCCTGAATTTACTTCGTGTGAATTTTATTGGGCATATGCT	0
KRS_1GGA	TATGAAATTGGTGGAGTATTTAGAAATGAAGGTATAGATAATACACATAATCCTGAATTTACTTCGTGTGAATTTTATTGGGCATATGCT	0
KRS_1GGG	TATGAAATTGGTGGGGTATTTAGAAATGAAGGTATAGATAATACACATAATCCTGAATTTACTTCGTGTGAATTTTATTGGGCATATGCT	0
KRS21TTT	TATGAAATTGGTAAAGTATTTAGAAATGAAGGTATAGATAATACACATAATCCTGAATTTACTTCGTGTGAATTTTTTTGGGCATATGCT	13
KRS21TTC	TATGAAATTGGTAAAGTATTTAGAAATGAAGGTATAGATAATACACATAATCCTGAATTTACTTCGTGTGAATTTTTCTGGGCATATGCT	0
KRS21TTA	TATGAAATTGGTAAAGTATTTAGAAATGAAGGTATAGATAATACACATAATCCTGAATTTACTTCGTGTGAATTTTTATGGGCATATGCT	0
KRS21TTG	TATGAAATTGGTAAAGTATTTAGAAATGAAGGTATAGATAATACACATAATCCTGAATTTACTTCGTGTGAATTTTTGTGGGCATATGCT	0
KRS21CTT	TATGAAATTGGTAAAGTATTTAGAAATGAAGGTATAGATAATACACATAATCCTGAATTTACTTCGTGTGAATTTCTTTGGGCATATGCT	0
KRS21CTC	TATGAAATTGGTAAAGTATTTAGAAATGAAGGTATAGATAATACACATAATCCTGAATTTACTTCGTGTGAATTTCTCTGGGCATATGCT	0
KRS21CTA	TATGAAATTGGTAAAGTATTTAGAAATGAAGGTATAGATAATACACATAATCCTGAATTTACTTCGTGTGAATTTCTATGGGCATATGCT	0
KRS21CTG	TATGAAATTGGTAAAGTATTTAGAAATGAAGGTATAGATAATACACATAATCCTGAATTTACTTCGTGTGAATTTCTGTGGGCATATGCT	0
KRS21ATT	TATGAAATTGGTAAAGTATTTAGAAATGAAGGTATAGATAATACACATAATCCTGAATTTACTTCGTGTGAATTTATTTGGGCATATGCT	0
KRS21ATC	TATGAAATTGGTAAAGTATTTAGAAATGAAGGTATAGATAATACACATAATCCTGAATTTACTTCGTGTGAATTTATCTGGGCATATGCT	0
KRS21ATA	TATGAAATTGGTAAAGTATTTAGAAATGAAGGTATAGATAATACACATAATCCTGAATTTACTTCGTGTGAATTTATATGGGCATATGCT	0
KRS21ATG	TATGAAATTGGTAAAGTATTTAGAAATGAAGGTATAGATAATACACATAATCCTGAATTTACTTCGTGTGAATTTATGTGGGCATATGCT	0
KRS21GTT	TATGAAATTGGTAAAGTATTTAGAAATGAAGGTATAGATAATACACATAATCCTGAATTTACTTCGTGTGAATTTGTTTGGGCATATGCT	0
KRS21GTC	TATGAAATTGGTAAAGTATTTAGAAATGAAGGTATAGATAATACACATAATCCTGAATTTACTTCGTGTGAATTTGTCTGGGCATATGCT	0
KRS21GTA	TATGAAATTGGTAAAGTATTTAGAAATGAAGGTATAGATAATACACATAATCCTGAATTTACTTCGTGTGAATTTGTATGGGCATATGCT	0
KRS21GTG	TATGAAATTGGTAAAGTATTTAGAAATGAAGGTATAGATAATACACATAATCCTGAATTTACTTCGTGTGAATTTGTGTGGGCATATGCT	0
KRS21TCT	TATGAAATTGGTAAAGTATTTAGAAATGAAGGTATAGATAATACACATAATCCTGAATTTACTTCGTGTGAATTTTCTTGGGCATATGCT	4
KRS21TCC	TATGAAATTGGTAAAGTATTTAGAAATGAAGGTATAGATAATACACATAATCCTGAATTTACTTCGTGTGAATTTTCCTGGGCATATGCT	0
KRS21TCA	TATGAAATTGGTAAAGTATTTAGAAATGAAGGTATAGATAATACACATAATCCTGAATTTACTTCGTGTGAATTTTCATGGGCATATGCT	0
KRS21TCG	TATGAAATTGGTAAAGTATTTAGAAATGAAGGTATAGATAATACACATAATCCTGAATTTACTTCGTGTGAATTTTCGTGGGCATATGCT	0
KRS21CCT	TATGAAATTGGTAAAGTATTTAGAAATGAAGGTATAGATAATACACATAATCCTGAATTTACTTCGTGTGAATTTCCTTGGGCATATGCT	0
KRS21CCC	TATGAAATTGGTAAAGTATTTAGAAATGAAGGTATAGATAATACACATAATCCTGAATTTACTTCGTGTGAATTTCCCTGGGCATATGCT	0
KRS21CCA	TATGAAATTGGTAAAGTATTTAGAAATGAAGGTATAGATAATACACATAATCCTGAATTTACTTCGTGTGAATTTCCATGGGCATATGCT	0
KRS21CCG	TATGAAATTGGTAAAGTATTTAGAAATGAAGGTATAGATAATACACATAATCCTGAATTTACTTCGTGTGAATTTCCGTGGGCATATGCT	0
KRS21ACT	TATGAAATTGGTAAAGTATTTAGAAATGAAGGTATAGATAATACACATAATCCTGAATTTACTTCGTGTGAATTTACTTGGGCATATGCT	0
KRS21ACC	TATGAAATTGGTAAAGTATTTAGAAATGAAGGTATAGATAATACACATAATCCTGAATTTACTTCGTGTGAATTTACCTGGGCATATGCT	0
KRS21ACA	TATGAAATTGGTAAAGTATTTAGAAATGAAGGTATAGATAATACACATAATCCTGAATTTACTTCGTGTGAATTTACATGGGCATATGCT	0
KRS21ACG	TATGAAATTGGTAAAGTATTTAGAAATGAAGGTATAGATAATACACATAATCCTGAATTTACTTCGTGTGAATTTACGTGGGCATATGCT	0
KRS21GCT	TATGAAATTGGTAAAGTATTTAGAAATGAAGGTATAGATAATACACATAATCCTGAATTTACTTCGTGTGAATTTGCTTGGGCATATGCT	0
KRS21GCC	TATGAAATTGGTAAAGTATTTAGAAATGAAGGTATAGATAATACACATAATCCTGAATTTACTTCGTGTGAATTTGCCTGGGCATATGCT	0
KRS21GCA	TATGAAATTGGTAAAGTATTTAGAAATGAAGGTATAGATAATACACATAATCCTGAATTTACTTCGTGTGAATTTGCATGGGCATATGCT	0
KRS21GCG	TATGAAATTGGTAAAGTATTTAGAAATGAAGGTATAGATAATACACATAATCCTGAATTTACTTCGTGTGAATTTGCGTGGGCATATGCT	0
KRS21TAT	TATGAAATTGGTAAAGTATTTAGAAATGAAGGTATAGATAATACACATAATCCTGAATTTACTTCGTGTGAATTTTATTGGGCATATGCT	40702
KRS21TAC	TATGAAATTGGTAAAGTATTTAGAAATGAAGGTATAGATAATACACATAATCCTGAATTTACTTCGTGTGAATTTTACTGGGCATATGCT	54
KRS21TAA	TATGAAATTGGTAAAGTATTTAGAAATGAAGGTATAGATAATACACATAATCCTGAATTTACTTCGTGTGAATTTTAATGGGCATATGCT	15
KRS21TAG	TATGAAATTGGTAAAGTATTTAGAAATGAAGGTATAGATAATACACATAATCCTGAATTTACTTCGTGTGAATTTTAGTGGGCATATGCT	3
KRS21CAT	TATGAAATTGGTAAAGTATTTAGAAATGAAGGTATAGATAATACACATAATCCTGAATTTACTTCGTGTGAATTTCATTGGGCATATGCT	35
KRS21CAC	TATGAAATTGGTAAAGTATTTAGAAATGAAGGTATAGATAATACACATAATCCTGAATTTACTTCGTGTGAATTTCACTGGGCATATGCT	0
KRS21CAA	TATGAAATTGGTAAAGTATTTAGAAATGAAGGTATAGATAATACACATAATCCTGAATTTACTTCGTGTGAATTTCAATGGGCATATGCT	0
KRS21CAG	TATGAAATTGGTAAAGTATTTAGAAATGAAGGTATAGATAATACACATAATCCTGAATTTACTTCGTGTGAATTTCAGTGGGCATATGCT	0
KRS21AAT	TATGAAATTGGTAAAGTATTTAGAAATGAAGGTATAGATAATACACATAATCCTGAATTTACTTCGTGTGAATTTAATTGGGCATATGCT	17
KRS21AAC	TATGAAATTGGTAAAGTATTTAGAAATGAAGGTATAGATAATACACATAATCCTGAATTTACTTCGTGTGAATTTAACTGGGCATATGCT	0
KRS21AAA	TATGAAATTGGTAAAGTATTTAGAAATGAAGGTATAGATAATACACATAATCCTGAATTTACTTCGTGTGAATTTAAATGGGCATATGCT	0
KRS21AAG	TATGAAATTGGTAAAGTATTTAGAAATGAAGGTATAGATAATACACATAATCCTGAATTTACTTCGTGTGAATTTAAGTGGGCATATGCT	0
KRS21GAT	TATGAAATTGGTAAAGTATTTAGAAATGAAGGTATAGATAATACACATAATCCTGAATTTACTTCGTGTGAATTTGATTGGGCATATGCT	3
KRS21GAC	TATGAAATTGGTAAAGTATTTAGAAATGAAGGTATAGATAATACACATAATCCTGAATTTACTTCGTGTGAATTTGACTGGGCATATGCT	0
KRS21GAA	TATGAAATTGGTAAAGTATTTAGAAATGAAGGTATAGATAATACACATAATCCTGAATTTACTTCGTGTGAATTTGAATGGGCATATGCT	0
KRS21GAG	TATGAAATTGGTAAAGTATTTAGAAATGAAGGTATAGATAATACACATAATCCTGAATTTACTTCGTGTGAATTTGAGTGGGCATATGCT	0
KRS21TGT	TATGAAATTGGTAAAGTATTTAGAAATGAAGGTATAGATAATACACATAATCCTGAATTTACTTCGTGTGAATTTTGTTGGGCATATGCT	38
KRS21TGC	TATGAAATTGGTAAAGTATTTAGAAATGAAGGTATAGATAATACACATAATCCTGAATTTACTTCGTGTGAATTTTGCTGGGCATATGCT	0
KRS21TGA	TATGAAATTGGTAAAGTATTTAGAAATGAAGGTATAGATAATACACATAATCCTGAATTTACTTCGTGTGAATTTTGATGGGCATATGCT	0
KRS21TGG	TATGAAATTGGTAAAGTATTTAGAAATGAAGGTATAGATAATACACATAATCCTGAATTTACTTCGTGTGAATTTTGGTGGGCATATGCT	0
KRS21CGT	TATGAAATTGGTAAAGTATTTAGAAATGAAGGTATAGATAATACACATAATCCTGAATTTACTTCGTGTGAATTTCGTTGGGCATATGCT	0
KRS21CGC	TATGAAATTGGTAAAGTATTTAGAAATGAAGGTATAGATAATACACATAATCCTGAATTTACTTCGTGTGAATTTCGCTGGGCATATGCT	0
KRS21CGA	TATGAAATTGGTAAAGTATTTAGAAATGAAGGTATAGATAATACACATAATCCTGAATTTACTTCGTGTGAATTTCGATGGGCATATGCT	0
KRS21CGG	TATGAAATTGGTAAAGTATTTAGAAATGAAGGTATAGATAATACACATAATCCTGAATTTACTTCGTGTGAATTTCGGTGGGCATATGCT	0
KRS21AGT	TATGAAATTGGTAAAGTATTTAGAAATGAAGGTATAGATAATACACATAATCCTGAATTTACTTCGTGTGAATTTAGTTGGGCATATGCT	0
KRS21AGC	TATGAAATTGGTAAAGTATTTAGAAATGAAGGTATAGATAATACACATAATCCTGAATTTACTTCGTGTGAATTTAGCTGGGCATATGCT	0
KRS21AGA	TATGAAATTGGTAAAGTATTTAGAAATGAAGGTATAGATAATACACATAATCCTGAATTTACTTCGTGTGAATTTAGATGGGCATATGCT	0
KRS21AGG	TATGAAATTGGTAAAGTATTTAGAAATGAAGGTATAGATAATACACATAATCCTGAATTTACTTCGTGTGAATTTAGGTGGGCATATGCT	0
KRS21GGT	TATGAAATTGGTAAAGTATTTAGAAATGAAGGTATAGATAATACACATAATCCTGAATTTACTTCGTGTGAATTTGGTTGGGCATATGCT	0
KRS21GGC	TATGAAATTGGTAAAGTATTTAGAAATGAAGGTATAGATAATACACATAATCCTGAATTTACTTCGTGTGAATTTGGCTGGGCATATGCT	0
KRS21GGA	TATGAAATTGGTAAAGTATTTAGAAATGAAGGTATAGATAATACACATAATCCTGAATTTACTTCGTGTGAATTTGGATGGGCATATGCT	0
KRS21GGG	TATGAAATTGGTAAAGTATTTAGAAATGAAGGTATAGATAATACACATAATCCTGAATTTACTTCGTGTGAATTTGGGTGGGCATATGCT	0
