Name	Sequence	Count
KRS1TTT	TATGAAATTGGTAAATTTTTTAGAAATGAAGGTATAGATAATACACATAATCCTGAATTTACTTCGTGTGAATTTTATTGGGCATATGCT	70324
KRS1TTC	TATGAAATTGGTAAATTCTTTAGAAATGAAGGTATAGATAATACACATAATCCTGAATTTACTTCGTGTGAATTTTATTGGGCATATGCT	185
KRS1TTA	TATGAAATTGGTAAATTATTTAGAAATGAAGGTATAGATAATACACATAATCCTGAATTTACTTCGTGTGAATTTTATTGGGCATATGCT	267
KRS1TTG	TATGAAATTGGTAAATTGTTTAGAAATGAAGGTATAGATAATACACATAATCCTGAATTTACTTCGTGTGAATTTTATTGGGCATATGCT	13546
KRS1CTT	TATGAAATTGGTAAACTTTTTAGAAATGAAGGTATAGATAATACACATAATCCTGAATTTACTTCGTGTGAATTTTATTGGGCATATGCT	68001
KRS1CTC	TATGAAATTGGTAAACTCTTTAGAAATGAAGGTATAGATAATACACATAATCCTGAATTTACTTCGTGTGAATTTTATTGGGCATATGCT	265
KRS1CTA	TATGAAATTGGTAAACTATTTAGAAATGAAGGTATAGATAATACACATAATCCTGAATTTACTTCGTGTGAATTTTATTGGGCATATGCT	210
KRS1CTG	TATGAAATTGGTAAACTGTTTAGAAATGAAGGTATAGATAATACACATAATCCTGAATTTACTTCGTGTGAATTTTATTGGGCATATGCT	81
KRS1ATT	TATGAAATTGGTAAAATTTTTAGAAATGAAGGTATAGATAATACACATAATCCTGAATTTACTTCGTGTGAATTTTATTGGGCATATGCT	80
KRS1ATC	TATGAAATTGGTAAAATCTTTAGAAATGAAGGTATAGATAATACACATAATCCTGAATTTACTTCGTGTGAATTTTATTGGGCATATGCT	41
KRS1ATA	TATGAAATTGGTAAAATATTTAGAAATGAAGGTATAGATAATACACATAATCCTGAATTTACTTCGTGTGAATTTTATTGGGCATATGCT	50
KRS1ATG	TATGAAATTGGTAAAATGTTTAGAAATGAAGGTATAGATAATACACATAATCCTGAATTTACTTCGTGTGAATTTTATTGGGCATATGCT	11
KRS1GTT	TATGAAATTGGTAAAGTTTTTAGAAATGAAGGTATAGATAATACACATAATCCTGAATTTACTTCGTGTGAATTTTATTGGGCATATGCT	362
KRS1GTC	TATGAAATTGGTAAAGTCTTTAGAAATGAAGGTATAGATAATACACATAATCCTGAATTTACTTCGTGTGAATTTTATTGGGCATATGCT	1816
KRS1GTA	TATGAAATTGGTAAAGTATTTAGAAATGAAGGTATAGATAATACACATAATCCTGAATTTACTTCGTGTGAATTTTATTGGGCATATGCT	91560
KRS1GTG	TATGAAATTGGTAAAGTGTTTAGAAATGAAGGTATAGATAATACACATAATCCTGAATTTACTTCGTGTGAATTTTATTGGGCATATGCT	211
KRS1TCT	TATGAAATTGGTAAATCTTTTAGAAATGAAGGTATAGATAATACACATAATCCTGAATTTACTTCGTGTGAATTTTATTGGGCATATGCT	12947
KRS1TCC	TATGAAATTGGTAAATCCTTTAGAAATGAAGGTATAGATAATACACATAATCCTGAATTTACTTCGTGTGAATTTTATTGGGCATATGCT	318
KRS1TCA	TATGAAATTGGTAAATCATTTAGAAATGAAGGTATAGATAATACACATAATCCTGAATTTACTTCGTGTGAATTTTATTGGGCATATGCT	3833
KRS1TCG	TATGAAATTGGTAAATCGTTTAGAAATGAAGGTATAGATAATACACATAATCCTGAATTTACTTCGTGTGAATTTTATTGGGCATATGCT	186445
KRS1CCT	TATGAAATTGGTAAACCTTTTAGAAATGAAGGTATAGATAATACACATAATCCTGAATTTACTTCGTGTGAATTTTATTGGGCATATGCT	268
KRS1CCC	TATGAAATTGGTAAACCCTTTAGAAATGAAGGTATAGATAATACACATAATCCTGAATTTACTTCGTGTGAATTTTATTGGGCATATGCT	3572
KRS1CCA	TATGAAATTGGTAAACCATTTAGAAATGAAGGTATAGATAATACACATAATCCTGAATTTACTTCGTGTGAATTTTATTGGGCATATGCT	34
KRS1CCG	TATGAAATTGGTAAACCGTTTAGAAATGAAGGTATAGATAATACACATAATCCTGAATTTACTTCGTGTGAATTTTATTGGGCATATGCT	419
KRS1ACT	TATGAAATTGGTAAAACTTTTAGAAATGAAGGTATAGATAATACACATAATCCTGAATTTACTTCGTGTGAATTTTATTGGGCATATGCT	169
KRS1ACC	TATGAAATTGGTAAAACCTTTAGAAATGAAGGTATAGATAATACACATAATCCTGAATTTACTTCGTGTGAATTTTATTGGGCATATGCT	142
KRS1ACA	TATGAAATTGGTAAAACATTTAGAAATGAAGGTATAGATAATACACATAATCCTGAATTTACTTCGTGTGAATTTTATTGGGCATATGCT	2347
KRS1ACG	TATGAAATTGGTAAAACGTTTAGAAATGAAGGTATAGATAATACACATAATCCTGAATTTACTTCGTGTGAATTTTATTGGGCATATGCT	1966
KRS1GCT	TATGAAATTGGTAAAGCTTTTAGAAATGAAGGTATAGATAATACACATAATCCTGAATTTACTTCGTGTGAATTTTATTGGGCATATGCT	200
KRS1GCC	TATGAAATTGGTAAAGCCTTTAGAAATGAAGGTATAGATAATACACATAATCCTGAATTTACTTCGTGTGAATTTTATTGGGCATATGCT	102
KRS1GCA	TATGAAATTGGTAAAGCATTTAGAAATGAAGGTATAGATAATACACATAATCCTGAATTTACTTCGTGTGAATTTTATTGGGCATATGCT	117
KRS1GCG	TATGAAATTGGTAAAGCGTTTAGAAATGAAGGTATAGATAATACACATAATCCTGAATTTACTTCGTGTGAATTTTATTGGGCATATGCT	108
KRS1TAT	TATGAAATTGGTAAATATTTTAGAAATGAAGGTATAGATAATACACATAATCCTGAATTTACTTCGTGTGAATTTTATTGGGCATATGCT	60
KRS1TAC	TATGAAATTGGTAAATACTTTAGAAATGAAGGTATAGATAATACACATAATCCTGAATTTACTTCGTGTGAATTTTATTGGGCATATGCT	18
KRS1TAA	TATGAAATTGGTAAATAATTTAGAAATGAAGGTATAGATAATACACATAATCCTGAATTTACTTCGTGTGAATTTTATTGGGCATATGCT	7
KRS1TAG	TATGAAATTGGTAAATAGTTTAGAAATGAAGGTATAGATAATACACATAATCCTGAATTTACTTCGTGTGAATTTTATTGGGCATATGCT	55
KRS1CAT	TATGAAATTGGTAAACATTTTAGAAATGAAGGTATAGATAATACACATAATCCTGAATTTACTTCGTGTGAATTTTATTGGGCATATGCT	347
KRS1CAC	TATGAAATTGGTAAACACTTTAGAAATGAAGGTATAGATAATACACATAATCCTGAATTTACTTCGTGTGAATTTTATTGGGCATATGCT	18744
KRS1CAA	TATGAAATTGGTAAACAATTTAGAAATGAAGGTATAGATAATACACATAATCCTGAATTTACTTCGTGTGAATTTTATTGGGCATATGCT	40
KRS1CAG	TATGAAATTGGTAAACAGTTTAGAAATGAAGGTATAGATAATACACATAATCCTGAATTTACTTCGTGTGAATTTTATTGGGCATATGCT	53
KRS1AAT	TATGAAATTGGTAAAAATTTTAGAAATGAAGGTATAGATAATACACATAATCCTGAATTTACTTCGTGTGAATTTTATTGGGCATATGCT	17813
KRS1AAC	TATGAAATTGGTAAAAACTTTAGAAATGAAGGTATAGATAATACACATAATCCTGAATTTACTTCGTGTGAATTTTATTGGGCATATGCT	322
KRS1AAA	TATGAAATTGGTAAAAAATTTAGAAATGAAGGTATAGATAATACACATAATCCTGAATTTACTTCGTGTGAATTTTATTGGGCATATGCT	15
KRS1AAG	TATGAAATTGGTAAAAAGTTTAGAAATGAAGGTATAGATAATACACATAATCCTGAATTTACTTCGTGTGAATTTTATTGGGCATATGCT	8
KRS1GAT	TATGAAATTGGTAAAGATTTTAGAAATGAAGGTATAGATAATACACATAATCCTGAATTTACTTCGTGTGAATTTTATTGGGCATATGCT	97
KRS1GAC	TATGAAATTGGTAAAGACTTTAGAAATGAAGGTATAGATAATACACATAATCCTGAATTTACTTCGTGTGAATTTTATTGGGCATATGCT	8494
KRS1GAA	TATGAAATTGGTAAAGAATTTAGAAATGAAGGTATAGATAATACACATAATCCTGAATTTACTTCGTGTGAATTTTATTGGGCATATGCT	127
KRS1GAG	TATGAAATTGGTAAAGAGTTTAGAAATGAAGGTATAGATAATACACATAATCCTGAATTTACTTCGTGTGAATTTTATTGGGCATATGCT	26
KRS1TGT	TATGAAATTGGTAAATGTTTTAGAAATGAAGGTATAGATAATACACATAATCCTGAATTTACTTCGTGTGAATTTTATTGGGCATATGCT	6719
KRS1TGC	TATGAAATTGGTAAATGCTTTAGAAATGAAGGTATAGATAATACACATAATCCTGAATTTACTTCGTGTGAATTTTATTGGGCATATGCT	1699
KRS1TGA	TATGAAATTGGTAAATGATTTAGAAATGAAGGTATAGATAATACACATAATCCTGAATTTACTTCGTGTGAATTTTATTGGGCATATGCT	3657
KRS1TGG	TATGAAATTGGTAAATGGTTTAGAAATGAAGGTATAGATAATACACATAATCCTGAATTTACTTCGTGTGAATTTTATTGGGCATATGCT	824
KRS1CGT	TATGAAATTGGTAAACGTTTTAGAAATGAAGGTATAGATAATACACATAATCCTGAATTTACTTCGTGTGAATTTTATTGGGCATATGCT	99
KRS1CGC	TATGAAATTGGTAAACGCTTTAGAAATGAAGGTATAGATAATACACATAATCCTGAATTTACTTCGTGTGAATTTTATTGGGCATATGCT	201
KRS1CGA	TATGAAATTGGTAAACGATTTAGAAATGAAGGTATAGATAATACACATAATCCTGAATTTACTTCGTGTGAATTTTATTGGGCATATGCT	9
KRS1CGG	TATGAAATTGGTAAACGGTTTAGAAATGAAGGTATAGATAATACACATAATCCTGAATTTACTTCGTGTGAATTTTATTGGGCATATGCT	9
KRS1AGT	TATGAAATTGGTAAAAGTTTTAGAAATGAAGGTATAGATAATACACATAATCCTGAATTTACTTCGTGTGAATTTTATTGGGCATATGCT	89
KRS1AGC	TATGAAATTGGTAAAAGCTTTAGAAATGAAGGTATAGATAATACACATAATCCTGAATTTACTTCGTGTGAATTTTATTGGGCATATGCT	3
KRS1AGA	TATGAAATTGGTAAAAGATTTAGAAATGAAGGTATAGATAATACACATAATCCTGAATTTACTTCGTGTGAATTTTATTGGGCATATGCT	8
KRS1AGG	TATGAAATTGGTAAAAGGTTTAGAAATGAAGGTATAGATAATACACATAATCCTGAATTTACTTCGTGTGAATTTTATTGGGCATATGCT	13
KRS1GGT	TATGAAATTGGTAAAGGTTTTAGAAATGAAGGTATAGATAATACACATAATCCTGAATTTACTTCGTGTGAATTTTATTGGGCATATGCT	119024
KRS1GGC	TATGAAATTGGTAAAGGCTTTAGAAATGAAGGTATAGATAATACACATAATCCTGAATTTACTTCGTGTGAATTTTATTGGGCATATGCT	294
KRS1GGA	TATGAAATTGGTAAAGGATTTAGAAATGAAGGTATAGATAATACACATAATCCTGAATTTACTTCGTGTGAATTTTATTGGGCATATGCT	1729
KRS1GGG	TATGAAATTGGTAAAGGGTTTAGAAATGAAGGTATAGATAATACACATAATCCTGAATTTACTTCGTGTGAATTTTATTGGGCATATGCT	97
KRS2TTT	TATGAAATTGGTAAAGTATTTAGAAATGAAGGTATAGATAATACACATAATCCTGAATTTACTTCGTGTGAATTTTATTGGGCATATGCT	91560
KRS2TTC	TATGAAATTGGTAAAGTATTCAGAAATGAAGGTATAGATAATACACATAATCCTGAATTTACTTCGTGTGAATTTTATTGGGCATATGCT	131
KRS2TTA	TATGAAATTGGTAAAGTATTAAGAAATGAAGGTATAGATAATACACATAATCCTGAATTTACTTCGTGTGAATTTTATTGGGCATATGCT	135
KRS2TTG	TATGAAATTGGTAAAGTATTGAGAAATGAAGGTATAGATAATACACATAATCCTGAATTTACTTCGTGTGAATTTTATTGGGCATATGCT	33
KRS2CTT	TATGAAATTGGTAAAGTACTTAGAAATGAAGGTATAGATAATACACATAATCCTGAATTTACTTCGTGTGAATTTTATTGGGCATATGCT	260
KRS2CTC	TATGAAATTGGTAAAGTACTCAGAAATGAAGGTATAGATAATACACATAATCCTGAATTTACTTCGTGTGAATTTTATTGGGCATATGCT	78
KRS2CTA	TATGAAATTGGTAAAGTACTAAGAAATGAAGGTATAGATAATACACATAATCCTGAATTTACTTCGTGTGAATTTTATTGGGCATATGCT	4
KRS2CTG	TATGAAATTGGTAAAGTACTGAGAAATGAAGGTATAGATAATACACATAATCCTGAATTTACTTCGTGTGAATTTTATTGGGCATATGCT	10
KRS2ATT	TATGAAATTGGTAAAGTAATTAGAAATGAAGGTATAGATAATACACATAATCCTGAATTTACTTCGTGTGAATTTTATTGGGCATATGCT	97
KRS2ATC	TATGAAATTGGTAAAGTAATCAGAAATGAAGGTATAGATAATACACATAATCCTGAATTTACTTCGTGTGAATTTTATTGGGCATATGCT	29
KRS2ATA	TATGAAATTGGTAAAGTAATAAGAAATGAAGGTATAGATAATACACATAATCCTGAATTTACTTCGTGTGAATTTTATTGGGCATATGCT	217
KRS2ATG	TATGAAATTGGTAAAGTAATGAGAAATGAAGGTATAGATAATACACATAATCCTGAATTTACTTCGTGTGAATTTTATTGGGCATATGCT	8
KRS2GTT	TATGAAATTGGTAAAGTAGTTAGAAATGAAGGTATAGATAATACACATAATCCTGAATTTACTTCGTGTGAATTTTATTGGGCATATGCT	4594
KRS2GTC	TATGAAATTGGTAAAGTAGTCAGAAATGAAGGTATAGATAATACACATAATCCTGAATTTACTTCGTGTGAATTTTATTGGGCATATGCT	11
KRS2GTA	TATGAAATTGGTAAAGTAGTAAGAAATGAAGGTATAGATAATACACATAATCCTGAATTTACTTCGTGTGAATTTTATTGGGCATATGCT	412
KRS2GTG	TATGAAATTGGTAAAGTAGTGAGAAATGAAGGTATAGATAATACACATAATCCTGAATTTACTTCGTGTGAATTTTATTGGGCATATGCT	3
KRS2TCT	TATGAAATTGGTAAAGTATCTAGAAATGAAGGTATAGATAATACACATAATCCTGAATTTACTTCGTGTGAATTTTATTGGGCATATGCT	377
KRS2TCC	TATGAAATTGGTAAAGTATCCAGAAATGAAGGTATAGATAATACACATAATCCTGAATTTACTTCGTGTGAATTTTATTGGGCATATGCT	50
KRS2TCA	TATGAAATTGGTAAAGTATCAAGAAATGAAGGTATAGATAATACACATAATCCTGAATTTACTTCGTGTGAATTTTATTGGGCATATGCT	5065
KRS2TCG	TATGAAATTGGTAAAGTATCGAGAAATGAAGGTATAGATAATACACATAATCCTGAATTTACTTCGTGTGAATTTTATTGGGCATATGCT	25
KRS2CCT	TATGAAATTGGTAAAGTACCTAGAAATGAAGGTATAGATAATACACATAATCCTGAATTTACTTCGTGTGAATTTTATTGGGCATATGCT	19
KRS2CCC	TATGAAATTGGTAAAGTACCCAGAAATGAAGGTATAGATAATACACATAATCCTGAATTTACTTCGTGTGAATTTTATTGGGCATATGCT	18925
KRS2CCA	TATGAAATTGGTAAAGTACCAAGAAATGAAGGTATAGATAATACACATAATCCTGAATTTACTTCGTGTGAATTTTATTGGGCATATGCT	123
KRS2CCG	TATGAAATTGGTAAAGTACCGAGAAATGAAGGTATAGATAATACACATAATCCTGAATTTACTTCGTGTGAATTTTATTGGGCATATGCT	5009
KRS2ACT	TATGAAATTGGTAAAGTAACTAGAAATGAAGGTATAGATAATACACATAATCCTGAATTTACTTCGTGTGAATTTTATTGGGCATATGCT	6
KRS2ACC	TATGAAATTGGTAAAGTAACCAGAAATGAAGGTATAGATAATACACATAATCCTGAATTTACTTCGTGTGAATTTTATTGGGCATATGCT	11
KRS2ACA	TATGAAATTGGTAAAGTAACAAGAAATGAAGGTATAGATAATACACATAATCCTGAATTTACTTCGTGTGAATTTTATTGGGCATATGCT	1401
KRS2ACG	TATGAAATTGGTAAAGTAACGAGAAATGAAGGTATAGATAATACACATAATCCTGAATTTACTTCGTGTGAATTTTATTGGGCATATGCT	7
KRS2GCT	TATGAAATTGGTAAAGTAGCTAGAAATGAAGGTATAGATAATACACATAATCCTGAATTTACTTCGTGTGAATTTTATTGGGCATATGCT	25
KRS2GCC	TATGAAATTGGTAAAGTAGCCAGAAATGAAGGTATAGATAATACACATAATCCTGAATTTACTTCGTGTGAATTTTATTGGGCATATGCT	53
KRS2GCA	TATGAAATTGGTAAAGTAGCAAGAAATGAAGGTATAGATAATACACATAATCCTGAATTTACTTCGTGTGAATTTTATTGGGCATATGCT	14
KRS2GCG	TATGAAATTGGTAAAGTAGCGAGAAATGAAGGTATAGATAATACACATAATCCTGAATTTACTTCGTGTGAATTTTATTGGGCATATGCT	29
KRS2TAT	TATGAAATTGGTAAAGTATATAGAAATGAAGGTATAGATAATACACATAATCCTGAATTTACTTCGTGTGAATTTTATTGGGCATATGCT	143
KRS2TAC	TATGAAATTGGTAAAGTATACAGAAATGAAGGTATAGATAATACACATAATCCTGAATTTACTTCGTGTGAATTTTATTGGGCATATGCT	7
KRS2TAA	TATGAAATTGGTAAAGTATAAAGAAATGAAGGTATAGATAATACACATAATCCTGAATTTACTTCGTGTGAATTTTATTGGGCATATGCT	18910
KRS2TAG	TATGAAATTGGTAAAGTATAGAGAAATGAAGGTATAGATAATACACATAATCCTGAATTTACTTCGTGTGAATTTTATTGGGCATATGCT	49
KRS2CAT	TATGAAATTGGTAAAGTACATAGAAATGAAGGTATAGATAATACACATAATCCTGAATTTACTTCGTGTGAATTTTATTGGGCATATGCT	133
KRS2CAC	TATGAAATTGGTAAAGTACACAGAAATGAAGGTATAGATAATACACATAATCCTGAATTTACTTCGTGTGAATTTTATTGGGCATATGCT	98
KRS2CAA	TATGAAATTGGTAAAGTACAAAGAAATGAAGGTATAGATAATACACATAATCCTGAATTTACTTCGTGTGAATTTTATTGGGCATATGCT	213
KRS2CAG	TATGAAATTGGTAAAGTACAGAGAAATGAAGGTATAGATAATACACATAATCCTGAATTTACTTCGTGTGAATTTTATTGGGCATATGCT	15
KRS2AAT	TATGAAATTGGTAAAGTAAATAGAAATGAAGGTATAGATAATACACATAATCCTGAATTTACTTCGTGTGAATTTTATTGGGCATATGCT	1
KRS2AAC	TATGAAATTGGTAAAGTAAACAGAAATGAAGGTATAGATAATACACATAATCCTGAATTTACTTCGTGTGAATTTTATTGGGCATATGCT	3
KRS2AAA	TATGAAATTGGTAAAGTAAAAAGAAATGAAGGTATAGATAATACACATAATCCTGAATTTACTTCGTGTGAATTTTATTGGGCATATGCT	2688
KRS2AAG	TATGAAATTGGTAAAGTAAAGAGAAATGAAGGTATAGATAATACACATAATCCTGAATTTACTTCGTGTGAATTTTATTGGGCATATGCT	12
KRS2GAT	TATGAAATTGGTAAAGTAGATAGAAATGAAGGTATAGATAATACACATAATCCTGAATTTACTTCGTGTGAATTTTATTGGGCATATGCT	12
KRS2GAC	TATGAAATTGGTAAAGTAGACAGAAATGAAGGTATAGATAATACACATAATCCTGAATTTACTTCGTGTGAATTTTATTGGGCATATGCT	1
KRS2GAA	TATGAAATTGGTAAAGTAGAAAGAAATGAAGGTATAGATAATACACATAATCCTGAATTTACTTCGTGTGAATTTTATTGGGCATATGCT	97
KRS2GAG	TATGAAATTGGTAAAGTAGAGAGAAATGAAGGTATAGATAATACACATAATCCTGAATTTACTTCGTGTGAATTTTATTGGGCATATGCT	3
KRS2TGT	TATGAAATTGGTAAAGTATGTAGAAATGAAGGTATAGATAATACACATAATCCTGAATTTACTTCGTGTGAATTTTATTGGGCATATGCT	52
KRS2TGC	TATGAAATTGGTAAAGTATGCAGAAATGAAGGTATAGATAATACACATAATCCTGAATTTACTTCGTGTGAATTTTATTGGGCATATGCT	0
KRS2TGA	TATGAAATTGGTAAAGTATGAAGAAATGAAGGTATAGATAATACACATAATCCTGAATTTACTTCGTGTGAATTTTATTGGGCATATGCT	40
KRS2TGG	TATGAAATTGGTAAAGTATGGAGAAATGAAGGTATAGATAATACACATAATCCTGAATTTACTTCGTGTGAATTTTATTGGGCATATGCT	3
KRS2CGT	TATGAAATTGGTAAAGTACGTAGAAATGAAGGTATAGATAATACACATAATCCTGAATTTACTTCGTGTGAATTTTATTGGGCATATGCT	3
KRS2CGC	TATGAAATTGGTAAAGTACGCAGAAATGAAGGTATAGATAATACACATAATCCTGAATTTACTTCGTGTGAATTTTATTGGGCATATGCT	81
KRS2CGA	TATGAAATTGGTAAAGTACGAAGAAATGAAGGTATAGATAATACACATAATCCTGAATTTACTTCGTGTGAATTTTATTGGGCATATGCT	5
KRS2CGG	TATGAAATTGGTAAAGTACGGAGAAATGAAGGTATAGATAATACACATAATCCTGAATTTACTTCGTGTGAATTTTATTGGGCATATGCT	20
KRS2AGT	TATGAAATTGGTAAAGTAAGTAGAAATGAAGGTATAGATAATACACATAATCCTGAATTTACTTCGTGTGAATTTTATTGGGCATATGCT	2
KRS2AGC	TATGAAATTGGTAAAGTAAGCAGAAATGAAGGTATAGATAATACACATAATCCTGAATTTACTTCGTGTGAATTTTATTGGGCATATGCT	0
KRS2AGA	TATGAAATTGGTAAAGTAAGAAGAAATGAAGGTATAGATAATACACATAATCCTGAATTTACTTCGTGTGAATTTTATTGGGCATATGCT	13
KRS2AGG	TATGAAATTGGTAAAGTAAGGAGAAATGAAGGTATAGATAATACACATAATCCTGAATTTACTTCGTGTGAATTTTATTGGGCATATGCT	3
KRS2GGT	TATGAAATTGGTAAAGTAGGTAGAAATGAAGGTATAGATAATACACATAATCCTGAATTTACTTCGTGTGAATTTTATTGGGCATATGCT	15
KRS2GGC	TATGAAATTGGTAAAGTAGGCAGAAATGAAGGTATAGATAATACACATAATCCTGAATTTACTTCGTGTGAATTTTATTGGGCATATGCT	4
KRS2GGA	TATGAAATTGGTAAAGTAGGAAGAAATGAAGGTATAGATAATACACATAATCCTGAATTTACTTCGTGTGAATTTTATTGGGCATATGCT	4
KRS2GGG	TATGAAATTGGTAAAGTAGGGAGAAATGAAGGTATAGATAATACACATAATCCTGAATTTACTTCGTGTGAATTTTATTGGGCATATGCT	29
KRS3TTT	TATGAAATTGGTAAAGTATTTTTTAATGAAGGTATAGATAATACACATAATCCTGAATTTACTTCGTGTGAATTTTATTGGGCATATGCT	10
KRS3TTC	TATGAAATTGGTAAAGTATTTTTCAATGAAGGTATAGATAATACACATAATCCTGAATTTACTTCGTGTGAATTTTATTGGGCATATGCT	5
KRS3TTA	TATGAAATTGGTAAAGTATTTTTAAATGAAGGTATAGATAATACACATAATCCTGAATTTACTTCGTGTGAATTTTATTGGGCATATGCT	2
KRS3TTG	TATGAAATTGGTAAAGTATTTTTGAATGAAGGTATAGATAATACACATAATCCTGAATTTACTTCGTGTGAATTTTATTGGGCATATGCT	3
KRS3CTT	TATGAAATTGGTAAAGTATTTCTTAATGAAGGTATAGATAATACACATAATCCTGAATTTACTTCGTGTGAATTTTATTGGGCATATGCT	3
KRS3CTC	TATGAAATTGGTAAAGTATTTCTCAATGAAGGTATAGATAATACACATAATCCTGAATTTACTTCGTGTGAATTTTATTGGGCATATGCT	0
KRS3CTA	TATGAAATTGGTAAAGTATTTCTAAATGAAGGTATAGATAATACACATAATCCTGAATTTACTTCGTGTGAATTTTATTGGGCATATGCT	1
KRS3CTG	TATGAAATTGGTAAAGTATTTCTGAATGAAGGTATAGATAATACACATAATCCTGAATTTACTTCGTGTGAATTTTATTGGGCATATGCT	1
KRS3ATT	TATGAAATTGGTAAAGTATTTATTAATGAAGGTATAGATAATACACATAATCCTGAATTTACTTCGTGTGAATTTTATTGGGCATATGCT	3
KRS3ATC	TATGAAATTGGTAAAGTATTTATCAATGAAGGTATAGATAATACACATAATCCTGAATTTACTTCGTGTGAATTTTATTGGGCATATGCT	0
KRS3ATA	TATGAAATTGGTAAAGTATTTATAAATGAAGGTATAGATAATACACATAATCCTGAATTTACTTCGTGTGAATTTTATTGGGCATATGCT	10
KRS3ATG	TATGAAATTGGTAAAGTATTTATGAATGAAGGTATAGATAATACACATAATCCTGAATTTACTTCGTGTGAATTTTATTGGGCATATGCT	1
KRS3GTT	TATGAAATTGGTAAAGTATTTGTTAATGAAGGTATAGATAATACACATAATCCTGAATTTACTTCGTGTGAATTTTATTGGGCATATGCT	5
KRS3GTC	TATGAAATTGGTAAAGTATTTGTCAATGAAGGTATAGATAATACACATAATCCTGAATTTACTTCGTGTGAATTTTATTGGGCATATGCT	0
KRS3GTA	TATGAAATTGGTAAAGTATTTGTAAATGAAGGTATAGATAATACACATAATCCTGAATTTACTTCGTGTGAATTTTATTGGGCATATGCT	1
KRS3GTG	TATGAAATTGGTAAAGTATTTGTGAATGAAGGTATAGATAATACACATAATCCTGAATTTACTTCGTGTGAATTTTATTGGGCATATGCT	2
KRS3TCT	TATGAAATTGGTAAAGTATTTTCTAATGAAGGTATAGATAATACACATAATCCTGAATTTACTTCGTGTGAATTTTATTGGGCATATGCT	2
KRS3TCC	TATGAAATTGGTAAAGTATTTTCCAATGAAGGTATAGATAATACACATAATCCTGAATTTACTTCGTGTGAATTTTATTGGGCATATGCT	0
KRS3TCA	TATGAAATTGGTAAAGTATTTTCAAATGAAGGTATAGATAATACACATAATCCTGAATTTACTTCGTGTGAATTTTATTGGGCATATGCT	1
KRS3TCG	TATGAAATTGGTAAAGTATTTTCGAATGAAGGTATAGATAATACACATAATCCTGAATTTACTTCGTGTGAATTTTATTGGGCATATGCT	1
KRS3CCT	TATGAAATTGGTAAAGTATTTCCTAATGAAGGTATAGATAATACACATAATCCTGAATTTACTTCGTGTGAATTTTATTGGGCATATGCT	4
KRS3CCC	TATGAAATTGGTAAAGTATTTCCCAATGAAGGTATAGATAATACACATAATCCTGAATTTACTTCGTGTGAATTTTATTGGGCATATGCT	2
KRS3CCA	TATGAAATTGGTAAAGTATTTCCAAATGAAGGTATAGATAATACACATAATCCTGAATTTACTTCGTGTGAATTTTATTGGGCATATGCT	0
KRS3CCG	TATGAAATTGGTAAAGTATTTCCGAATGAAGGTATAGATAATACACATAATCCTGAATTTACTTCGTGTGAATTTTATTGGGCATATGCT	0
KRS3ACT	TATGAAATTGGTAAAGTATTTACTAATGAAGGTATAGATAATACACATAATCCTGAATTTACTTCGTGTGAATTTTATTGGGCATATGCT	1
KRS3ACC	TATGAAATTGGTAAAGTATTTACCAATGAAGGTATAGATAATACACATAATCCTGAATTTACTTCGTGTGAATTTTATTGGGCATATGCT	0
KRS3ACA	TATGAAATTGGTAAAGTATTTACAAATGAAGGTATAGATAATACACATAATCCTGAATTTACTTCGTGTGAATTTTATTGGGCATATGCT	59
KRS3ACG	TATGAAATTGGTAAAGTATTTACGAATGAAGGTATAGATAATACACATAATCCTGAATTTACTTCGTGTGAATTTTATTGGGCATATGCT	0
KRS3GCT	TATGAAATTGGTAAAGTATTTGCTAATGAAGGTATAGATAATACACATAATCCTGAATTTACTTCGTGTGAATTTTATTGGGCATATGCT	2
KRS3GCC	TATGAAATTGGTAAAGTATTTGCCAATGAAGGTATAGATAATACACATAATCCTGAATTTACTTCGTGTGAATTTTATTGGGCATATGCT	0
KRS3GCA	TATGAAATTGGTAAAGTATTTGCAAATGAAGGTATAGATAATACACATAATCCTGAATTTACTTCGTGTGAATTTTATTGGGCATATGCT	1
KRS3GCG	TATGAAATTGGTAAAGTATTTGCGAATGAAGGTATAGATAATACACATAATCCTGAATTTACTTCGTGTGAATTTTATTGGGCATATGCT	0
KRS3TAT	TATGAAATTGGTAAAGTATTTTATAATGAAGGTATAGATAATACACATAATCCTGAATTTACTTCGTGTGAATTTTATTGGGCATATGCT	8
KRS3TAC	TATGAAATTGGTAAAGTATTTTACAATGAAGGTATAGATAATACACATAATCCTGAATTTACTTCGTGTGAATTTTATTGGGCATATGCT	1
KRS3TAA	TATGAAATTGGTAAAGTATTTTAAAATGAAGGTATAGATAATACACATAATCCTGAATTTACTTCGTGTGAATTTTATTGGGCATATGCT	1
KRS3TAG	TATGAAATTGGTAAAGTATTTTAGAATGAAGGTATAGATAATACACATAATCCTGAATTTACTTCGTGTGAATTTTATTGGGCATATGCT	1
KRS3CAT	TATGAAATTGGTAAAGTATTTCATAATGAAGGTATAGATAATACACATAATCCTGAATTTACTTCGTGTGAATTTTATTGGGCATATGCT	1
KRS3CAC	TATGAAATTGGTAAAGTATTTCACAATGAAGGTATAGATAATACACATAATCCTGAATTTACTTCGTGTGAATTTTATTGGGCATATGCT	4
KRS3CAA	TATGAAATTGGTAAAGTATTTCAAAATGAAGGTATAGATAATACACATAATCCTGAATTTACTTCGTGTGAATTTTATTGGGCATATGCT	1
KRS3CAG	TATGAAATTGGTAAAGTATTTCAGAATGAAGGTATAGATAATACACATAATCCTGAATTTACTTCGTGTGAATTTTATTGGGCATATGCT	1
KRS3AAT	TATGAAATTGGTAAAGTATTTAATAATGAAGGTATAGATAATACACATAATCCTGAATTTACTTCGTGTGAATTTTATTGGGCATATGCT	3
KRS3AAC	TATGAAATTGGTAAAGTATTTAACAATGAAGGTATAGATAATACACATAATCCTGAATTTACTTCGTGTGAATTTTATTGGGCATATGCT	3
KRS3AAA	TATGAAATTGGTAAAGTATTTAAAAATGAAGGTATAGATAATACACATAATCCTGAATTTACTTCGTGTGAATTTTATTGGGCATATGCT	51
KRS3AAG	TATGAAATTGGTAAAGTATTTAAGAATGAAGGTATAGATAATACACATAATCCTGAATTTACTTCGTGTGAATTTTATTGGGCATATGCT	3
KRS3GAT	TATGAAATTGGTAAAGTATTTGATAATGAAGGTATAGATAATACACATAATCCTGAATTTACTTCGTGTGAATTTTATTGGGCATATGCT	2
KRS3GAC	TATGAAATTGGTAAAGTATTTGACAATGAAGGTATAGATAATACACATAATCCTGAATTTACTTCGTGTGAATTTTATTGGGCATATGCT	0
KRS3GAA	TATGAAATTGGTAAAGTATTTGAAAATGAAGGTATAGATAATACACATAATCCTGAATTTACTTCGTGTGAATTTTATTGGGCATATGCT	3
KRS3GAG	TATGAAATTGGTAAAGTATTTGAGAATGAAGGTATAGATAATACACATAATCCTGAATTTACTTCGTGTGAATTTTATTGGGCATATGCT	0
KRS3TGT	TATGAAATTGGTAAAGTATTTTGTAATGAAGGTATAGATAATACACATAATCCTGAATTTACTTCGTGTGAATTTTATTGGGCATATGCT	4
KRS3TGC	TATGAAATTGGTAAAGTATTTTGCAATGAAGGTATAGATAATACACATAATCCTGAATTTACTTCGTGTGAATTTTATTGGGCATATGCT	0
KRS3TGA	TATGAAATTGGTAAAGTATTTTGAAATGAAGGTATAGATAATACACATAATCCTGAATTTACTTCGTGTGAATTTTATTGGGCATATGCT	30
KRS3TGG	TATGAAATTGGTAAAGTATTTTGGAATGAAGGTATAGATAATACACATAATCCTGAATTTACTTCGTGTGAATTTTATTGGGCATATGCT	0
KRS3CGT	TATGAAATTGGTAAAGTATTTCGTAATGAAGGTATAGATAATACACATAATCCTGAATTTACTTCGTGTGAATTTTATTGGGCATATGCT	1
KRS3CGC	TATGAAATTGGTAAAGTATTTCGCAATGAAGGTATAGATAATACACATAATCCTGAATTTACTTCGTGTGAATTTTATTGGGCATATGCT	1
KRS3CGA	TATGAAATTGGTAAAGTATTTCGAAATGAAGGTATAGATAATACACATAATCCTGAATTTACTTCGTGTGAATTTTATTGGGCATATGCT	7
KRS3CGG	TATGAAATTGGTAAAGTATTTCGGAATGAAGGTATAGATAATACACATAATCCTGAATTTACTTCGTGTGAATTTTATTGGGCATATGCT	0
KRS3AGT	TATGAAATTGGTAAAGTATTTAGTAATGAAGGTATAGATAATACACATAATCCTGAATTTACTTCGTGTGAATTTTATTGGGCATATGCT	62
KRS3AGC	TATGAAATTGGTAAAGTATTTAGCAATGAAGGTATAGATAATACACATAATCCTGAATTTACTTCGTGTGAATTTTATTGGGCATATGCT	16
KRS3AGA	TATGAAATTGGTAAAGTATTTAGAAATGAAGGTATAGATAATACACATAATCCTGAATTTACTTCGTGTGAATTTTATTGGGCATATGCT	91560
KRS3AGG	TATGAAATTGGTAAAGTATTTAGGAATGAAGGTATAGATAATACACATAATCCTGAATTTACTTCGTGTGAATTTTATTGGGCATATGCT	209
KRS3GGT	TATGAAATTGGTAAAGTATTTGGTAATGAAGGTATAGATAATACACATAATCCTGAATTTACTTCGTGTGAATTTTATTGGGCATATGCT	0
KRS3GGC	TATGAAATTGGTAAAGTATTTGGCAATGAAGGTATAGATAATACACATAATCCTGAATTTACTTCGTGTGAATTTTATTGGGCATATGCT	1
KRS3GGA	TATGAAATTGGTAAAGTATTTGGAAATGAAGGTATAGATAATACACATAATCCTGAATTTACTTCGTGTGAATTTTATTGGGCATATGCT	138
KRS3GGG	TATGAAATTGGTAAAGTATTTGGGAATGAAGGTATAGATAATACACATAATCCTGAATTTACTTCGTGTGAATTTTATTGGGCATATGCT	2
KRS4TTT	TATGAAATTGGTAAAGTATTTAGATTTGAAGGTATAGATAATACACATAATCCTGAATTTACTTCGTGTGAATTTTATTGGGCATATGCT	22
KRS4TTC	TATGAAATTGGTAAAGTATTTAGATTCGAAGGTATAGATAATACACATAATCCTGAATTTACTTCGTGTGAATTTTATTGGGCATATGCT	0
KRS4TTA	TATGAAATTGGTAAAGTATTTAGATTAGAAGGTATAGATAATACACATAATCCTGAATTTACTTCGTGTGAATTTTATTGGGCATATGCT	1
KRS4TTG	TATGAAATTGGTAAAGTATTTAGATTGGAAGGTATAGATAATACACATAATCCTGAATTTACTTCGTGTGAATTTTATTGGGCATATGCT	2
KRS4CTT	TATGAAATTGGTAAAGTATTTAGACTTGAAGGTATAGATAATACACATAATCCTGAATTTACTTCGTGTGAATTTTATTGGGCATATGCT	0
KRS4CTC	TATGAAATTGGTAAAGTATTTAGACTCGAAGGTATAGATAATACACATAATCCTGAATTTACTTCGTGTGAATTTTATTGGGCATATGCT	1
KRS4CTA	TATGAAATTGGTAAAGTATTTAGACTAGAAGGTATAGATAATACACATAATCCTGAATTTACTTCGTGTGAATTTTATTGGGCATATGCT	2
KRS4CTG	TATGAAATTGGTAAAGTATTTAGACTGGAAGGTATAGATAATACACATAATCCTGAATTTACTTCGTGTGAATTTTATTGGGCATATGCT	2
KRS4ATT	TATGAAATTGGTAAAGTATTTAGAATTGAAGGTATAGATAATACACATAATCCTGAATTTACTTCGTGTGAATTTTATTGGGCATATGCT	44
KRS4ATC	TATGAAATTGGTAAAGTATTTAGAATCGAAGGTATAGATAATACACATAATCCTGAATTTACTTCGTGTGAATTTTATTGGGCATATGCT	1
KRS4ATA	TATGAAATTGGTAAAGTATTTAGAATAGAAGGTATAGATAATACACATAATCCTGAATTTACTTCGTGTGAATTTTATTGGGCATATGCT	1
KRS4ATG	TATGAAATTGGTAAAGTATTTAGAATGGAAGGTATAGATAATACACATAATCCTGAATTTACTTCGTGTGAATTTTATTGGGCATATGCT	2
KRS4GTT	TATGAAATTGGTAAAGTATTTAGAGTTGAAGGTATAGATAATACACATAATCCTGAATTTACTTCGTGTGAATTTTATTGGGCATATGCT	4
KRS4GTC	TATGAAATTGGTAAAGTATTTAGAGTCGAAGGTATAGATAATACACATAATCCTGAATTTACTTCGTGTGAATTTTATTGGGCATATGCT	1
KRS4GTA	TATGAAATTGGTAAAGTATTTAGAGTAGAAGGTATAGATAATACACATAATCCTGAATTTACTTCGTGTGAATTTTATTGGGCATATGCT	1
KRS4GTG	TATGAAATTGGTAAAGTATTTAGAGTGGAAGGTATAGATAATACACATAATCCTGAATTTACTTCGTGTGAATTTTATTGGGCATATGCT	0
KRS4TCT	TATGAAATTGGTAAAGTATTTAGATCTGAAGGTATAGATAATACACATAATCCTGAATTTACTTCGTGTGAATTTTATTGGGCATATGCT	5
KRS4TCC	TATGAAATTGGTAAAGTATTTAGATCCGAAGGTATAGATAATACACATAATCCTGAATTTACTTCGTGTGAATTTTATTGGGCATATGCT	2
KRS4TCA	TATGAAATTGGTAAAGTATTTAGATCAGAAGGTATAGATAATACACATAATCCTGAATTTACTTCGTGTGAATTTTATTGGGCATATGCT	2
KRS4TCG	TATGAAATTGGTAAAGTATTTAGATCGGAAGGTATAGATAATACACATAATCCTGAATTTACTTCGTGTGAATTTTATTGGGCATATGCT	0
KRS4CCT	TATGAAATTGGTAAAGTATTTAGACCTGAAGGTATAGATAATACACATAATCCTGAATTTACTTCGTGTGAATTTTATTGGGCATATGCT	2
KRS4CCC	TATGAAATTGGTAAAGTATTTAGACCCGAAGGTATAGATAATACACATAATCCTGAATTTACTTCGTGTGAATTTTATTGGGCATATGCT	1
KRS4CCA	TATGAAATTGGTAAAGTATTTAGACCAGAAGGTATAGATAATACACATAATCCTGAATTTACTTCGTGTGAATTTTATTGGGCATATGCT	4
KRS4CCG	TATGAAATTGGTAAAGTATTTAGACCGGAAGGTATAGATAATACACATAATCCTGAATTTACTTCGTGTGAATTTTATTGGGCATATGCT	3
KRS4ACT	TATGAAATTGGTAAAGTATTTAGAACTGAAGGTATAGATAATACACATAATCCTGAATTTACTTCGTGTGAATTTTATTGGGCATATGCT	12
KRS4ACC	TATGAAATTGGTAAAGTATTTAGAACCGAAGGTATAGATAATACACATAATCCTGAATTTACTTCGTGTGAATTTTATTGGGCATATGCT	3
KRS4ACA	TATGAAATTGGTAAAGTATTTAGAACAGAAGGTATAGATAATACACATAATCCTGAATTTACTTCGTGTGAATTTTATTGGGCATATGCT	0
KRS4ACG	TATGAAATTGGTAAAGTATTTAGAACGGAAGGTATAGATAATACACATAATCCTGAATTTACTTCGTGTGAATTTTATTGGGCATATGCT	0
KRS4GCT	TATGAAATTGGTAAAGTATTTAGAGCTGAAGGTATAGATAATACACATAATCCTGAATTTACTTCGTGTGAATTTTATTGGGCATATGCT	1
KRS4GCC	TATGAAATTGGTAAAGTATTTAGAGCCGAAGGTATAGATAATACACATAATCCTGAATTTACTTCGTGTGAATTTTATTGGGCATATGCT	0
KRS4GCA	TATGAAATTGGTAAAGTATTTAGAGCAGAAGGTATAGATAATACACATAATCCTGAATTTACTTCGTGTGAATTTTATTGGGCATATGCT	4
KRS4GCG	TATGAAATTGGTAAAGTATTTAGAGCGGAAGGTATAGATAATACACATAATCCTGAATTTACTTCGTGTGAATTTTATTGGGCATATGCT	0
KRS4TAT	TATGAAATTGGTAAAGTATTTAGATATGAAGGTATAGATAATACACATAATCCTGAATTTACTTCGTGTGAATTTTATTGGGCATATGCT	66
KRS4TAC	TATGAAATTGGTAAAGTATTTAGATACGAAGGTATAGATAATACACATAATCCTGAATTTACTTCGTGTGAATTTTATTGGGCATATGCT	0
KRS4TAA	TATGAAATTGGTAAAGTATTTAGATAAGAAGGTATAGATAATACACATAATCCTGAATTTACTTCGTGTGAATTTTATTGGGCATATGCT	1
KRS4TAG	TATGAAATTGGTAAAGTATTTAGATAGGAAGGTATAGATAATACACATAATCCTGAATTTACTTCGTGTGAATTTTATTGGGCATATGCT	3
KRS4CAT	TATGAAATTGGTAAAGTATTTAGACATGAAGGTATAGATAATACACATAATCCTGAATTTACTTCGTGTGAATTTTATTGGGCATATGCT	17
KRS4CAC	TATGAAATTGGTAAAGTATTTAGACACGAAGGTATAGATAATACACATAATCCTGAATTTACTTCGTGTGAATTTTATTGGGCATATGCT	2
KRS4CAA	TATGAAATTGGTAAAGTATTTAGACAAGAAGGTATAGATAATACACATAATCCTGAATTTACTTCGTGTGAATTTTATTGGGCATATGCT	2
KRS4CAG	TATGAAATTGGTAAAGTATTTAGACAGGAAGGTATAGATAATACACATAATCCTGAATTTACTTCGTGTGAATTTTATTGGGCATATGCT	2
KRS4AAT	TATGAAATTGGTAAAGTATTTAGAAATGAAGGTATAGATAATACACATAATCCTGAATTTACTTCGTGTGAATTTTATTGGGCATATGCT	91560
KRS4AAC	TATGAAATTGGTAAAGTATTTAGAAACGAAGGTATAGATAATACACATAATCCTGAATTTACTTCGTGTGAATTTTATTGGGCATATGCT	153
KRS4AAA	TATGAAATTGGTAAAGTATTTAGAAAAGAAGGTATAGATAATACACATAATCCTGAATTTACTTCGTGTGAATTTTATTGGGCATATGCT	56
KRS4AAG	TATGAAATTGGTAAAGTATTTAGAAAGGAAGGTATAGATAATACACATAATCCTGAATTTACTTCGTGTGAATTTTATTGGGCATATGCT	12
KRS4GAT	TATGAAATTGGTAAAGTATTTAGAGATGAAGGTATAGATAATACACATAATCCTGAATTTACTTCGTGTGAATTTTATTGGGCATATGCT	276
KRS4GAC	TATGAAATTGGTAAAGTATTTAGAGACGAAGGTATAGATAATACACATAATCCTGAATTTACTTCGTGTGAATTTTATTGGGCATATGCT	1
KRS4GAA	TATGAAATTGGTAAAGTATTTAGAGAAGAAGGTATAGATAATACACATAATCCTGAATTTACTTCGTGTGAATTTTATTGGGCATATGCT	4
KRS4GAG	TATGAAATTGGTAAAGTATTTAGAGAGGAAGGTATAGATAATACACATAATCCTGAATTTACTTCGTGTGAATTTTATTGGGCATATGCT	0
KRS4TGT	TATGAAATTGGTAAAGTATTTAGATGTGAAGGTATAGATAATACACATAATCCTGAATTTACTTCGTGTGAATTTTATTGGGCATATGCT	6
KRS4TGC	TATGAAATTGGTAAAGTATTTAGATGCGAAGGTATAGATAATACACATAATCCTGAATTTACTTCGTGTGAATTTTATTGGGCATATGCT	0
KRS4TGA	TATGAAATTGGTAAAGTATTTAGATGAGAAGGTATAGATAATACACATAATCCTGAATTTACTTCGTGTGAATTTTATTGGGCATATGCT	1
KRS4TGG	TATGAAATTGGTAAAGTATTTAGATGGGAAGGTATAGATAATACACATAATCCTGAATTTACTTCGTGTGAATTTTATTGGGCATATGCT	0
KRS4CGT	TATGAAATTGGTAAAGTATTTAGACGTGAAGGTATAGATAATACACATAATCCTGAATTTACTTCGTGTGAATTTTATTGGGCATATGCT	0
KRS4CGC	TATGAAATTGGTAAAGTATTTAGACGCGAAGGTATAGATAATACACATAATCCTGAATTTACTTCGTGTGAATTTTATTGGGCATATGCT	3
KRS4CGA	TATGAAATTGGTAAAGTATTTAGACGAGAAGGTATAGATAATACACATAATCCTGAATTTACTTCGTGTGAATTTTATTGGGCATATGCT	0
KRS4CGG	TATGAAATTGGTAAAGTATTTAGACGGGAAGGTATAGATAATACACATAATCCTGAATTTACTTCGTGTGAATTTTATTGGGCATATGCT	1
KRS4AGT	TATGAAATTGGTAAAGTATTTAGAAGTGAAGGTATAGATAATACACATAATCCTGAATTTACTTCGTGTGAATTTTATTGGGCATATGCT	226
KRS4AGC	TATGAAATTGGTAAAGTATTTAGAAGCGAAGGTATAGATAATACACATAATCCTGAATTTACTTCGTGTGAATTTTATTGGGCATATGCT	1
KRS4AGA	TATGAAATTGGTAAAGTATTTAGAAGAGAAGGTATAGATAATACACATAATCCTGAATTTACTTCGTGTGAATTTTATTGGGCATATGCT	1
KRS4AGG	TATGAAATTGGTAAAGTATTTAGAAGGGAAGGTATAGATAATACACATAATCCTGAATTTACTTCGTGTGAATTTTATTGGGCATATGCT	4
KRS4GGT	TATGAAATTGGTAAAGTATTTAGAGGTGAAGGTATAGATAATACACATAATCCTGAATTTACTTCGTGTGAATTTTATTGGGCATATGCT	0
KRS4GGC	TATGAAATTGGTAAAGTATTTAGAGGCGAAGGTATAGATAATACACATAATCCTGAATTTACTTCGTGTGAATTTTATTGGGCATATGCT	1
KRS4GGA	TATGAAATTGGTAAAGTATTTAGAGGAGAAGGTATAGATAATACACATAATCCTGAATTTACTTCGTGTGAATTTTATTGGGCATATGCT	1
KRS4GGG	TATGAAATTGGTAAAGTATTTAGAGGGGAAGGTATAGATAATACACATAATCCTGAATTTACTTCGTGTGAATTTTATTGGGCATATGCT	0
KRS5TTT	TATGAAATTGGTAAAGTATTTAGAAATTTTGGTATAGATAATACACATAATCCTGAATTTACTTCGTGTGAATTTTATTGGGCATATGCT	42
KRS5TTC	TATGAAATTGGTAAAGTATTTAGAAATTTCGGTATAGATAATACACATAATCCTGAATTTACTTCGTGTGAATTTTATTGGGCATATGCT	5
KRS5TTA	TATGAAATTGGTAAAGTATTTAGAAATTTAGGTATAGATAATACACATAATCCTGAATTTACTTCGTGTGAATTTTATTGGGCATATGCT	7
KRS5TTG	TATGAAATTGGTAAAGTATTTAGAAATTTGGGTATAGATAATACACATAATCCTGAATTTACTTCGTGTGAATTTTATTGGGCATATGCT	12
KRS5CTT	TATGAAATTGGTAAAGTATTTAGAAATCTTGGTATAGATAATACACATAATCCTGAATTTACTTCGTGTGAATTTTATTGGGCATATGCT	12
KRS5CTC	TATGAAATTGGTAAAGTATTTAGAAATCTCGGTATAGATAATACACATAATCCTGAATTTACTTCGTGTGAATTTTATTGGGCATATGCT	0
KRS5CTA	TATGAAATTGGTAAAGTATTTAGAAATCTAGGTATAGATAATACACATAATCCTGAATTTACTTCGTGTGAATTTTATTGGGCATATGCT	4
KRS5CTG	TATGAAATTGGTAAAGTATTTAGAAATCTGGGTATAGATAATACACATAATCCTGAATTTACTTCGTGTGAATTTTATTGGGCATATGCT	4
KRS5ATT	TATGAAATTGGTAAAGTATTTAGAAATATTGGTATAGATAATACACATAATCCTGAATTTACTTCGTGTGAATTTTATTGGGCATATGCT	34
KRS5ATC	TATGAAATTGGTAAAGTATTTAGAAATATCGGTATAGATAATACACATAATCCTGAATTTACTTCGTGTGAATTTTATTGGGCATATGCT	11
KRS5ATA	TATGAAATTGGTAAAGTATTTAGAAATATAGGTATAGATAATACACATAATCCTGAATTTACTTCGTGTGAATTTTATTGGGCATATGCT	7
KRS5ATG	TATGAAATTGGTAAAGTATTTAGAAATATGGGTATAGATAATACACATAATCCTGAATTTACTTCGTGTGAATTTTATTGGGCATATGCT	5
KRS5GTT	TATGAAATTGGTAAAGTATTTAGAAATGTTGGTATAGATAATACACATAATCCTGAATTTACTTCGTGTGAATTTTATTGGGCATATGCT	17
KRS5GTC	TATGAAATTGGTAAAGTATTTAGAAATGTCGGTATAGATAATACACATAATCCTGAATTTACTTCGTGTGAATTTTATTGGGCATATGCT	3
KRS5GTA	TATGAAATTGGTAAAGTATTTAGAAATGTAGGTATAGATAATACACATAATCCTGAATTTACTTCGTGTGAATTTTATTGGGCATATGCT	87
KRS5GTG	TATGAAATTGGTAAAGTATTTAGAAATGTGGGTATAGATAATACACATAATCCTGAATTTACTTCGTGTGAATTTTATTGGGCATATGCT	8
KRS5TCT	TATGAAATTGGTAAAGTATTTAGAAATTCTGGTATAGATAATACACATAATCCTGAATTTACTTCGTGTGAATTTTATTGGGCATATGCT	8
KRS5TCC	TATGAAATTGGTAAAGTATTTAGAAATTCCGGTATAGATAATACACATAATCCTGAATTTACTTCGTGTGAATTTTATTGGGCATATGCT	5
KRS5TCA	TATGAAATTGGTAAAGTATTTAGAAATTCAGGTATAGATAATACACATAATCCTGAATTTACTTCGTGTGAATTTTATTGGGCATATGCT	9
KRS5TCG	TATGAAATTGGTAAAGTATTTAGAAATTCGGGTATAGATAATACACATAATCCTGAATTTACTTCGTGTGAATTTTATTGGGCATATGCT	1
KRS5CCT	TATGAAATTGGTAAAGTATTTAGAAATCCTGGTATAGATAATACACATAATCCTGAATTTACTTCGTGTGAATTTTATTGGGCATATGCT	5
KRS5CCC	TATGAAATTGGTAAAGTATTTAGAAATCCCGGTATAGATAATACACATAATCCTGAATTTACTTCGTGTGAATTTTATTGGGCATATGCT	5
KRS5CCA	TATGAAATTGGTAAAGTATTTAGAAATCCAGGTATAGATAATACACATAATCCTGAATTTACTTCGTGTGAATTTTATTGGGCATATGCT	7
KRS5CCG	TATGAAATTGGTAAAGTATTTAGAAATCCGGGTATAGATAATACACATAATCCTGAATTTACTTCGTGTGAATTTTATTGGGCATATGCT	2
KRS5ACT	TATGAAATTGGTAAAGTATTTAGAAATACTGGTATAGATAATACACATAATCCTGAATTTACTTCGTGTGAATTTTATTGGGCATATGCT	12
KRS5ACC	TATGAAATTGGTAAAGTATTTAGAAATACCGGTATAGATAATACACATAATCCTGAATTTACTTCGTGTGAATTTTATTGGGCATATGCT	6
KRS5ACA	TATGAAATTGGTAAAGTATTTAGAAATACAGGTATAGATAATACACATAATCCTGAATTTACTTCGTGTGAATTTTATTGGGCATATGCT	7
KRS5ACG	TATGAAATTGGTAAAGTATTTAGAAATACGGGTATAGATAATACACATAATCCTGAATTTACTTCGTGTGAATTTTATTGGGCATATGCT	2
KRS5GCT	TATGAAATTGGTAAAGTATTTAGAAATGCTGGTATAGATAATACACATAATCCTGAATTTACTTCGTGTGAATTTTATTGGGCATATGCT	20
KRS5GCC	TATGAAATTGGTAAAGTATTTAGAAATGCCGGTATAGATAATACACATAATCCTGAATTTACTTCGTGTGAATTTTATTGGGCATATGCT	2
KRS5GCA	TATGAAATTGGTAAAGTATTTAGAAATGCAGGTATAGATAATACACATAATCCTGAATTTACTTCGTGTGAATTTTATTGGGCATATGCT	32
KRS5GCG	TATGAAATTGGTAAAGTATTTAGAAATGCGGGTATAGATAATACACATAATCCTGAATTTACTTCGTGTGAATTTTATTGGGCATATGCT	4
KRS5TAT	TATGAAATTGGTAAAGTATTTAGAAATTATGGTATAGATAATACACATAATCCTGAATTTACTTCGTGTGAATTTTATTGGGCATATGCT	17
KRS5TAC	TATGAAATTGGTAAAGTATTTAGAAATTACGGTATAGATAATACACATAATCCTGAATTTACTTCGTGTGAATTTTATTGGGCATATGCT	8
KRS5TAA	TATGAAATTGGTAAAGTATTTAGAAATTAAGGTATAGATAATACACATAATCCTGAATTTACTTCGTGTGAATTTTATTGGGCATATGCT	17
KRS5TAG	TATGAAATTGGTAAAGTATTTAGAAATTAGGGTATAGATAATACACATAATCCTGAATTTACTTCGTGTGAATTTTATTGGGCATATGCT	7
KRS5CAT	TATGAAATTGGTAAAGTATTTAGAAATCATGGTATAGATAATACACATAATCCTGAATTTACTTCGTGTGAATTTTATTGGGCATATGCT	13
KRS5CAC	TATGAAATTGGTAAAGTATTTAGAAATCACGGTATAGATAATACACATAATCCTGAATTTACTTCGTGTGAATTTTATTGGGCATATGCT	7
KRS5CAA	TATGAAATTGGTAAAGTATTTAGAAATCAAGGTATAGATAATACACATAATCCTGAATTTACTTCGTGTGAATTTTATTGGGCATATGCT	64
KRS5CAG	TATGAAATTGGTAAAGTATTTAGAAATCAGGGTATAGATAATACACATAATCCTGAATTTACTTCGTGTGAATTTTATTGGGCATATGCT	2
KRS5AAT	TATGAAATTGGTAAAGTATTTAGAAATAATGGTATAGATAATACACATAATCCTGAATTTACTTCGTGTGAATTTTATTGGGCATATGCT	12
KRS5AAC	TATGAAATTGGTAAAGTATTTAGAAATAACGGTATAGATAATACACATAATCCTGAATTTACTTCGTGTGAATTTTATTGGGCATATGCT	1
KRS5AAA	TATGAAATTGGTAAAGTATTTAGAAATAAAGGTATAGATAATACACATAATCCTGAATTTACTTCGTGTGAATTTTATTGGGCATATGCT	59
KRS5AAG	TATGAAATTGGTAAAGTATTTAGAAATAAGGGTATAGATAATACACATAATCCTGAATTTACTTCGTGTGAATTTTATTGGGCATATGCT	5
KRS5GAT	TATGAAATTGGTAAAGTATTTAGAAATGATGGTATAGATAATACACATAATCCTGAATTTACTTCGTGTGAATTTTATTGGGCATATGCT	80
KRS5GAC	TATGAAATTGGTAAAGTATTTAGAAATGACGGTATAGATAATACACATAATCCTGAATTTACTTCGTGTGAATTTTATTGGGCATATGCT	15
KRS5GAA	TATGAAATTGGTAAAGTATTTAGAAATGAAGGTATAGATAATACACATAATCCTGAATTTACTTCGTGTGAATTTTATTGGGCATATGCT	91560
KRS5GAG	TATGAAATTGGTAAAGTATTTAGAAATGAGGGTATAGATAATACACATAATCCTGAATTTACTTCGTGTGAATTTTATTGGGCATATGCT	278
KRS5TGT	TATGAAATTGGTAAAGTATTTAGAAATTGTGGTATAGATAATACACATAATCCTGAATTTACTTCGTGTGAATTTTATTGGGCATATGCT	22
KRS5TGC	TATGAAATTGGTAAAGTATTTAGAAATTGCGGTATAGATAATACACATAATCCTGAATTTACTTCGTGTGAATTTTATTGGGCATATGCT	4
KRS5TGA	TATGAAATTGGTAAAGTATTTAGAAATTGAGGTATAGATAATACACATAATCCTGAATTTACTTCGTGTGAATTTTATTGGGCATATGCT	7
KRS5TGG	TATGAAATTGGTAAAGTATTTAGAAATTGGGGTATAGATAATACACATAATCCTGAATTTACTTCGTGTGAATTTTATTGGGCATATGCT	5
KRS5CGT	TATGAAATTGGTAAAGTATTTAGAAATCGTGGTATAGATAATACACATAATCCTGAATTTACTTCGTGTGAATTTTATTGGGCATATGCT	1
KRS5CGC	TATGAAATTGGTAAAGTATTTAGAAATCGCGGTATAGATAATACACATAATCCTGAATTTACTTCGTGTGAATTTTATTGGGCATATGCT	4
KRS5CGA	TATGAAATTGGTAAAGTATTTAGAAATCGAGGTATAGATAATACACATAATCCTGAATTTACTTCGTGTGAATTTTATTGGGCATATGCT	2
KRS5CGG	TATGAAATTGGTAAAGTATTTAGAAATCGGGGTATAGATAATACACATAATCCTGAATTTACTTCGTGTGAATTTTATTGGGCATATGCT	4
KRS5AGT	TATGAAATTGGTAAAGTATTTAGAAATAGTGGTATAGATAATACACATAATCCTGAATTTACTTCGTGTGAATTTTATTGGGCATATGCT	0
KRS5AGC	TATGAAATTGGTAAAGTATTTAGAAATAGCGGTATAGATAATACACATAATCCTGAATTTACTTCGTGTGAATTTTATTGGGCATATGCT	11
KRS5AGA	TATGAAATTGGTAAAGTATTTAGAAATAGAGGTATAGATAATACACATAATCCTGAATTTACTTCGTGTGAATTTTATTGGGCATATGCT	8
KRS5AGG	TATGAAATTGGTAAAGTATTTAGAAATAGGGGTATAGATAATACACATAATCCTGAATTTACTTCGTGTGAATTTTATTGGGCATATGCT	1
KRS5GGT	TATGAAATTGGTAAAGTATTTAGAAATGGTGGTATAGATAATACACATAATCCTGAATTTACTTCGTGTGAATTTTATTGGGCATATGCT	6
KRS5GGC	TATGAAATTGGTAAAGTATTTAGAAATGGCGGTATAGATAATACACATAATCCTGAATTTACTTCGTGTGAATTTTATTGGGCATATGCT	3
KRS5GGA	TATGAAATTGGTAAAGTATTTAGAAATGGAGGTATAGATAATACACATAATCCTGAATTTACTTCGTGTGAATTTTATTGGGCATATGCT	277
KRS5GGG	TATGAAATTGGTAAAGTATTTAGAAATGGGGGTATAGATAATACACATAATCCTGAATTTACTTCGTGTGAATTTTATTGGGCATATGCT	1
KRS6TTT	TATGAAATTGGTAAAGTATTTAGAAATGAATTTATAGATAATACACATAATCCTGAATTTACTTCGTGTGAATTTTATTGGGCATATGCT	82
KRS6TTC	TATGAAATTGGTAAAGTATTTAGAAATGAATTCATAGATAATACACATAATCCTGAATTTACTTCGTGTGAATTTTATTGGGCATATGCT	16
KRS6TTA	TATGAAATTGGTAAAGTATTTAGAAATGAATTAATAGATAATACACATAATCCTGAATTTACTTCGTGTGAATTTTATTGGGCATATGCT	7
KRS6TTG	TATGAAATTGGTAAAGTATTTAGAAATGAATTGATAGATAATACACATAATCCTGAATTTACTTCGTGTGAATTTTATTGGGCATATGCT	6
KRS6CTT	TATGAAATTGGTAAAGTATTTAGAAATGAACTTATAGATAATACACATAATCCTGAATTTACTTCGTGTGAATTTTATTGGGCATATGCT	4
KRS6CTC	TATGAAATTGGTAAAGTATTTAGAAATGAACTCATAGATAATACACATAATCCTGAATTTACTTCGTGTGAATTTTATTGGGCATATGCT	8
KRS6CTA	TATGAAATTGGTAAAGTATTTAGAAATGAACTAATAGATAATACACATAATCCTGAATTTACTTCGTGTGAATTTTATTGGGCATATGCT	9
KRS6CTG	TATGAAATTGGTAAAGTATTTAGAAATGAACTGATAGATAATACACATAATCCTGAATTTACTTCGTGTGAATTTTATTGGGCATATGCT	5
KRS6ATT	TATGAAATTGGTAAAGTATTTAGAAATGAAATTATAGATAATACACATAATCCTGAATTTACTTCGTGTGAATTTTATTGGGCATATGCT	15
KRS6ATC	TATGAAATTGGTAAAGTATTTAGAAATGAAATCATAGATAATACACATAATCCTGAATTTACTTCGTGTGAATTTTATTGGGCATATGCT	5
KRS6ATA	TATGAAATTGGTAAAGTATTTAGAAATGAAATAATAGATAATACACATAATCCTGAATTTACTTCGTGTGAATTTTATTGGGCATATGCT	8
KRS6ATG	TATGAAATTGGTAAAGTATTTAGAAATGAAATGATAGATAATACACATAATCCTGAATTTACTTCGTGTGAATTTTATTGGGCATATGCT	8
KRS6GTT	TATGAAATTGGTAAAGTATTTAGAAATGAAGTTATAGATAATACACATAATCCTGAATTTACTTCGTGTGAATTTTATTGGGCATATGCT	2149
KRS6GTC	TATGAAATTGGTAAAGTATTTAGAAATGAAGTCATAGATAATACACATAATCCTGAATTTACTTCGTGTGAATTTTATTGGGCATATGCT	4
KRS6GTA	TATGAAATTGGTAAAGTATTTAGAAATGAAGTAATAGATAATACACATAATCCTGAATTTACTTCGTGTGAATTTTATTGGGCATATGCT	6
KRS6GTG	TATGAAATTGGTAAAGTATTTAGAAATGAAGTGATAGATAATACACATAATCCTGAATTTACTTCGTGTGAATTTTATTGGGCATATGCT	1
KRS6TCT	TATGAAATTGGTAAAGTATTTAGAAATGAATCTATAGATAATACACATAATCCTGAATTTACTTCGTGTGAATTTTATTGGGCATATGCT	8
KRS6TCC	TATGAAATTGGTAAAGTATTTAGAAATGAATCCATAGATAATACACATAATCCTGAATTTACTTCGTGTGAATTTTATTGGGCATATGCT	15
KRS6TCA	TATGAAATTGGTAAAGTATTTAGAAATGAATCAATAGATAATACACATAATCCTGAATTTACTTCGTGTGAATTTTATTGGGCATATGCT	10
KRS6TCG	TATGAAATTGGTAAAGTATTTAGAAATGAATCGATAGATAATACACATAATCCTGAATTTACTTCGTGTGAATTTTATTGGGCATATGCT	1
KRS6CCT	TATGAAATTGGTAAAGTATTTAGAAATGAACCTATAGATAATACACATAATCCTGAATTTACTTCGTGTGAATTTTATTGGGCATATGCT	3
KRS6CCC	TATGAAATTGGTAAAGTATTTAGAAATGAACCCATAGATAATACACATAATCCTGAATTTACTTCGTGTGAATTTTATTGGGCATATGCT	5
KRS6CCA	TATGAAATTGGTAAAGTATTTAGAAATGAACCAATAGATAATACACATAATCCTGAATTTACTTCGTGTGAATTTTATTGGGCATATGCT	5
KRS6CCG	TATGAAATTGGTAAAGTATTTAGAAATGAACCGATAGATAATACACATAATCCTGAATTTACTTCGTGTGAATTTTATTGGGCATATGCT	1
KRS6ACT	TATGAAATTGGTAAAGTATTTAGAAATGAAACTATAGATAATACACATAATCCTGAATTTACTTCGTGTGAATTTTATTGGGCATATGCT	12
KRS6ACC	TATGAAATTGGTAAAGTATTTAGAAATGAAACCATAGATAATACACATAATCCTGAATTTACTTCGTGTGAATTTTATTGGGCATATGCT	7
KRS6ACA	TATGAAATTGGTAAAGTATTTAGAAATGAAACAATAGATAATACACATAATCCTGAATTTACTTCGTGTGAATTTTATTGGGCATATGCT	7
KRS6ACG	TATGAAATTGGTAAAGTATTTAGAAATGAAACGATAGATAATACACATAATCCTGAATTTACTTCGTGTGAATTTTATTGGGCATATGCT	3
KRS6GCT	TATGAAATTGGTAAAGTATTTAGAAATGAAGCTATAGATAATACACATAATCCTGAATTTACTTCGTGTGAATTTTATTGGGCATATGCT	108
KRS6GCC	TATGAAATTGGTAAAGTATTTAGAAATGAAGCCATAGATAATACACATAATCCTGAATTTACTTCGTGTGAATTTTATTGGGCATATGCT	7
KRS6GCA	TATGAAATTGGTAAAGTATTTAGAAATGAAGCAATAGATAATACACATAATCCTGAATTTACTTCGTGTGAATTTTATTGGGCATATGCT	11
KRS6GCG	TATGAAATTGGTAAAGTATTTAGAAATGAAGCGATAGATAATACACATAATCCTGAATTTACTTCGTGTGAATTTTATTGGGCATATGCT	3
KRS6TAT	TATGAAATTGGTAAAGTATTTAGAAATGAATATATAGATAATACACATAATCCTGAATTTACTTCGTGTGAATTTTATTGGGCATATGCT	49
KRS6TAC	TATGAAATTGGTAAAGTATTTAGAAATGAATACATAGATAATACACATAATCCTGAATTTACTTCGTGTGAATTTTATTGGGCATATGCT	4
KRS6TAA	TATGAAATTGGTAAAGTATTTAGAAATGAATAAATAGATAATACACATAATCCTGAATTTACTTCGTGTGAATTTTATTGGGCATATGCT	11
KRS6TAG	TATGAAATTGGTAAAGTATTTAGAAATGAATAGATAGATAATACACATAATCCTGAATTTACTTCGTGTGAATTTTATTGGGCATATGCT	4
KRS6CAT	TATGAAATTGGTAAAGTATTTAGAAATGAACATATAGATAATACACATAATCCTGAATTTACTTCGTGTGAATTTTATTGGGCATATGCT	12
KRS6CAC	TATGAAATTGGTAAAGTATTTAGAAATGAACACATAGATAATACACATAATCCTGAATTTACTTCGTGTGAATTTTATTGGGCATATGCT	12
KRS6CAA	TATGAAATTGGTAAAGTATTTAGAAATGAACAAATAGATAATACACATAATCCTGAATTTACTTCGTGTGAATTTTATTGGGCATATGCT	14
KRS6CAG	TATGAAATTGGTAAAGTATTTAGAAATGAACAGATAGATAATACACATAATCCTGAATTTACTTCGTGTGAATTTTATTGGGCATATGCT	8
KRS6AAT	TATGAAATTGGTAAAGTATTTAGAAATGAAAATATAGATAATACACATAATCCTGAATTTACTTCGTGTGAATTTTATTGGGCATATGCT	6
KRS6AAC	TATGAAATTGGTAAAGTATTTAGAAATGAAAACATAGATAATACACATAATCCTGAATTTACTTCGTGTGAATTTTATTGGGCATATGCT	12
KRS6AAA	TATGAAATTGGTAAAGTATTTAGAAATGAAAAAATAGATAATACACATAATCCTGAATTTACTTCGTGTGAATTTTATTGGGCATATGCT	13
KRS6AAG	TATGAAATTGGTAAAGTATTTAGAAATGAAAAGATAGATAATACACATAATCCTGAATTTACTTCGTGTGAATTTTATTGGGCATATGCT	3
KRS6GAT	TATGAAATTGGTAAAGTATTTAGAAATGAAGATATAGATAATACACATAATCCTGAATTTACTTCGTGTGAATTTTATTGGGCATATGCT	88
KRS6GAC	TATGAAATTGGTAAAGTATTTAGAAATGAAGACATAGATAATACACATAATCCTGAATTTACTTCGTGTGAATTTTATTGGGCATATGCT	3
KRS6GAA	TATGAAATTGGTAAAGTATTTAGAAATGAAGAAATAGATAATACACATAATCCTGAATTTACTTCGTGTGAATTTTATTGGGCATATGCT	5
KRS6GAG	TATGAAATTGGTAAAGTATTTAGAAATGAAGAGATAGATAATACACATAATCCTGAATTTACTTCGTGTGAATTTTATTGGGCATATGCT	8
KRS6TGT	TATGAAATTGGTAAAGTATTTAGAAATGAATGTATAGATAATACACATAATCCTGAATTTACTTCGTGTGAATTTTATTGGGCATATGCT	31
KRS6TGC	TATGAAATTGGTAAAGTATTTAGAAATGAATGCATAGATAATACACATAATCCTGAATTTACTTCGTGTGAATTTTATTGGGCATATGCT	9
KRS6TGA	TATGAAATTGGTAAAGTATTTAGAAATGAATGAATAGATAATACACATAATCCTGAATTTACTTCGTGTGAATTTTATTGGGCATATGCT	4
KRS6TGG	TATGAAATTGGTAAAGTATTTAGAAATGAATGGATAGATAATACACATAATCCTGAATTTACTTCGTGTGAATTTTATTGGGCATATGCT	4
KRS6CGT	TATGAAATTGGTAAAGTATTTAGAAATGAACGTATAGATAATACACATAATCCTGAATTTACTTCGTGTGAATTTTATTGGGCATATGCT	63
KRS6CGC	TATGAAATTGGTAAAGTATTTAGAAATGAACGCATAGATAATACACATAATCCTGAATTTACTTCGTGTGAATTTTATTGGGCATATGCT	1
KRS6CGA	TATGAAATTGGTAAAGTATTTAGAAATGAACGAATAGATAATACACATAATCCTGAATTTACTTCGTGTGAATTTTATTGGGCATATGCT	0
KRS6CGG	TATGAAATTGGTAAAGTATTTAGAAATGAACGGATAGATAATACACATAATCCTGAATTTACTTCGTGTGAATTTTATTGGGCATATGCT	0
KRS6AGT	TATGAAATTGGTAAAGTATTTAGAAATGAAAGTATAGATAATACACATAATCCTGAATTTACTTCGTGTGAATTTTATTGGGCATATGCT	57
KRS6AGC	TATGAAATTGGTAAAGTATTTAGAAATGAAAGCATAGATAATACACATAATCCTGAATTTACTTCGTGTGAATTTTATTGGGCATATGCT	1
KRS6AGA	TATGAAATTGGTAAAGTATTTAGAAATGAAAGAATAGATAATACACATAATCCTGAATTTACTTCGTGTGAATTTTATTGGGCATATGCT	6
KRS6AGG	TATGAAATTGGTAAAGTATTTAGAAATGAAAGGATAGATAATACACATAATCCTGAATTTACTTCGTGTGAATTTTATTGGGCATATGCT	10
KRS6GGT	TATGAAATTGGTAAAGTATTTAGAAATGAAGGTATAGATAATACACATAATCCTGAATTTACTTCGTGTGAATTTTATTGGGCATATGCT	91560
KRS6GGC	TATGAAATTGGTAAAGTATTTAGAAATGAAGGCATAGATAATACACATAATCCTGAATTTACTTCGTGTGAATTTTATTGGGCATATGCT	190
KRS6GGA	TATGAAATTGGTAAAGTATTTAGAAATGAAGGAATAGATAATACACATAATCCTGAATTTACTTCGTGTGAATTTTATTGGGCATATGCT	92
KRS6GGG	TATGAAATTGGTAAAGTATTTAGAAATGAAGGGATAGATAATACACATAATCCTGAATTTACTTCGTGTGAATTTTATTGGGCATATGCT	41
KRS7TTT	TATGAAATTGGTAAAGTATTTAGAAATGAAGGTTTTGATAATACACATAATCCTGAATTTACTTCGTGTGAATTTTATTGGGCATATGCT	48
KRS7TTC	TATGAAATTGGTAAAGTATTTAGAAATGAAGGTTTCGATAATACACATAATCCTGAATTTACTTCGTGTGAATTTTATTGGGCATATGCT	681
KRS7TTA	TATGAAATTGGTAAAGTATTTAGAAATGAAGGTTTAGATAATACACATAATCCTGAATTTACTTCGTGTGAATTTTATTGGGCATATGCT	46
KRS7TTG	TATGAAATTGGTAAAGTATTTAGAAATGAAGGTTTGGATAATACACATAATCCTGAATTTACTTCGTGTGAATTTTATTGGGCATATGCT	720
KRS7CTT	TATGAAATTGGTAAAGTATTTAGAAATGAAGGTCTTGATAATACACATAATCCTGAATTTACTTCGTGTGAATTTTATTGGGCATATGCT	46
KRS7CTC	TATGAAATTGGTAAAGTATTTAGAAATGAAGGTCTCGATAATACACATAATCCTGAATTTACTTCGTGTGAATTTTATTGGGCATATGCT	3
KRS7CTA	TATGAAATTGGTAAAGTATTTAGAAATGAAGGTCTAGATAATACACATAATCCTGAATTTACTTCGTGTGAATTTTATTGGGCATATGCT	13
KRS7CTG	TATGAAATTGGTAAAGTATTTAGAAATGAAGGTCTGGATAATACACATAATCCTGAATTTACTTCGTGTGAATTTTATTGGGCATATGCT	6
KRS7ATT	TATGAAATTGGTAAAGTATTTAGAAATGAAGGTATTGATAATACACATAATCCTGAATTTACTTCGTGTGAATTTTATTGGGCATATGCT	55
KRS7ATC	TATGAAATTGGTAAAGTATTTAGAAATGAAGGTATCGATAATACACATAATCCTGAATTTACTTCGTGTGAATTTTATTGGGCATATGCT	27
KRS7ATA	TATGAAATTGGTAAAGTATTTAGAAATGAAGGTATAGATAATACACATAATCCTGAATTTACTTCGTGTGAATTTTATTGGGCATATGCT	91560
KRS7ATG	TATGAAATTGGTAAAGTATTTAGAAATGAAGGTATGGATAATACACATAATCCTGAATTTACTTCGTGTGAATTTTATTGGGCATATGCT	167
KRS7GTT	TATGAAATTGGTAAAGTATTTAGAAATGAAGGTGTTGATAATACACATAATCCTGAATTTACTTCGTGTGAATTTTATTGGGCATATGCT	5
KRS7GTC	TATGAAATTGGTAAAGTATTTAGAAATGAAGGTGTCGATAATACACATAATCCTGAATTTACTTCGTGTGAATTTTATTGGGCATATGCT	55
KRS7GTA	TATGAAATTGGTAAAGTATTTAGAAATGAAGGTGTAGATAATACACATAATCCTGAATTTACTTCGTGTGAATTTTATTGGGCATATGCT	125
KRS7GTG	TATGAAATTGGTAAAGTATTTAGAAATGAAGGTGTGGATAATACACATAATCCTGAATTTACTTCGTGTGAATTTTATTGGGCATATGCT	11
KRS7TCT	TATGAAATTGGTAAAGTATTTAGAAATGAAGGTTCTGATAATACACATAATCCTGAATTTACTTCGTGTGAATTTTATTGGGCATATGCT	49
KRS7TCC	TATGAAATTGGTAAAGTATTTAGAAATGAAGGTTCCGATAATACACATAATCCTGAATTTACTTCGTGTGAATTTTATTGGGCATATGCT	8
KRS7TCA	TATGAAATTGGTAAAGTATTTAGAAATGAAGGTTCAGATAATACACATAATCCTGAATTTACTTCGTGTGAATTTTATTGGGCATATGCT	6
KRS7TCG	TATGAAATTGGTAAAGTATTTAGAAATGAAGGTTCGGATAATACACATAATCCTGAATTTACTTCGTGTGAATTTTATTGGGCATATGCT	3
KRS7CCT	TATGAAATTGGTAAAGTATTTAGAAATGAAGGTCCTGATAATACACATAATCCTGAATTTACTTCGTGTGAATTTTATTGGGCATATGCT	8
KRS7CCC	TATGAAATTGGTAAAGTATTTAGAAATGAAGGTCCCGATAATACACATAATCCTGAATTTACTTCGTGTGAATTTTATTGGGCATATGCT	4
KRS7CCA	TATGAAATTGGTAAAGTATTTAGAAATGAAGGTCCAGATAATACACATAATCCTGAATTTACTTCGTGTGAATTTTATTGGGCATATGCT	3
KRS7CCG	TATGAAATTGGTAAAGTATTTAGAAATGAAGGTCCGGATAATACACATAATCCTGAATTTACTTCGTGTGAATTTTATTGGGCATATGCT	1
KRS7ACT	TATGAAATTGGTAAAGTATTTAGAAATGAAGGTACTGATAATACACATAATCCTGAATTTACTTCGTGTGAATTTTATTGGGCATATGCT	1
KRS7ACC	TATGAAATTGGTAAAGTATTTAGAAATGAAGGTACCGATAATACACATAATCCTGAATTTACTTCGTGTGAATTTTATTGGGCATATGCT	5
KRS7ACA	TATGAAATTGGTAAAGTATTTAGAAATGAAGGTACAGATAATACACATAATCCTGAATTTACTTCGTGTGAATTTTATTGGGCATATGCT	174
KRS7ACG	TATGAAATTGGTAAAGTATTTAGAAATGAAGGTACGGATAATACACATAATCCTGAATTTACTTCGTGTGAATTTTATTGGGCATATGCT	2
KRS7GCT	TATGAAATTGGTAAAGTATTTAGAAATGAAGGTGCTGATAATACACATAATCCTGAATTTACTTCGTGTGAATTTTATTGGGCATATGCT	2
KRS7GCC	TATGAAATTGGTAAAGTATTTAGAAATGAAGGTGCCGATAATACACATAATCCTGAATTTACTTCGTGTGAATTTTATTGGGCATATGCT	1
KRS7GCA	TATGAAATTGGTAAAGTATTTAGAAATGAAGGTGCAGATAATACACATAATCCTGAATTTACTTCGTGTGAATTTTATTGGGCATATGCT	31
KRS7GCG	TATGAAATTGGTAAAGTATTTAGAAATGAAGGTGCGGATAATACACATAATCCTGAATTTACTTCGTGTGAATTTTATTGGGCATATGCT	0
KRS7TAT	TATGAAATTGGTAAAGTATTTAGAAATGAAGGTTATGATAATACACATAATCCTGAATTTACTTCGTGTGAATTTTATTGGGCATATGCT	4
KRS7TAC	TATGAAATTGGTAAAGTATTTAGAAATGAAGGTTACGATAATACACATAATCCTGAATTTACTTCGTGTGAATTTTATTGGGCATATGCT	9
KRS7TAA	TATGAAATTGGTAAAGTATTTAGAAATGAAGGTTAAGATAATACACATAATCCTGAATTTACTTCGTGTGAATTTTATTGGGCATATGCT	6
KRS7TAG	TATGAAATTGGTAAAGTATTTAGAAATGAAGGTTAGGATAATACACATAATCCTGAATTTACTTCGTGTGAATTTTATTGGGCATATGCT	3
KRS7CAT	TATGAAATTGGTAAAGTATTTAGAAATGAAGGTCATGATAATACACATAATCCTGAATTTACTTCGTGTGAATTTTATTGGGCATATGCT	3
KRS7CAC	TATGAAATTGGTAAAGTATTTAGAAATGAAGGTCACGATAATACACATAATCCTGAATTTACTTCGTGTGAATTTTATTGGGCATATGCT	9
KRS7CAA	TATGAAATTGGTAAAGTATTTAGAAATGAAGGTCAAGATAATACACATAATCCTGAATTTACTTCGTGTGAATTTTATTGGGCATATGCT	7
KRS7CAG	TATGAAATTGGTAAAGTATTTAGAAATGAAGGTCAGGATAATACACATAATCCTGAATTTACTTCGTGTGAATTTTATTGGGCATATGCT	84
KRS7AAT	TATGAAATTGGTAAAGTATTTAGAAATGAAGGTAATGATAATACACATAATCCTGAATTTACTTCGTGTGAATTTTATTGGGCATATGCT	14
KRS7AAC	TATGAAATTGGTAAAGTATTTAGAAATGAAGGTAACGATAATACACATAATCCTGAATTTACTTCGTGTGAATTTTATTGGGCATATGCT	12
KRS7AAA	TATGAAATTGGTAAAGTATTTAGAAATGAAGGTAAAGATAATACACATAATCCTGAATTTACTTCGTGTGAATTTTATTGGGCATATGCT	116
KRS7AAG	TATGAAATTGGTAAAGTATTTAGAAATGAAGGTAAGGATAATACACATAATCCTGAATTTACTTCGTGTGAATTTTATTGGGCATATGCT	7
KRS7GAT	TATGAAATTGGTAAAGTATTTAGAAATGAAGGTGATGATAATACACATAATCCTGAATTTACTTCGTGTGAATTTTATTGGGCATATGCT	2
KRS7GAC	TATGAAATTGGTAAAGTATTTAGAAATGAAGGTGACGATAATACACATAATCCTGAATTTACTTCGTGTGAATTTTATTGGGCATATGCT	3
KRS7GAA	TATGAAATTGGTAAAGTATTTAGAAATGAAGGTGAAGATAATACACATAATCCTGAATTTACTTCGTGTGAATTTTATTGGGCATATGCT	1427
KRS7GAG	TATGAAATTGGTAAAGTATTTAGAAATGAAGGTGAGGATAATACACATAATCCTGAATTTACTTCGTGTGAATTTTATTGGGCATATGCT	6
KRS7TGT	TATGAAATTGGTAAAGTATTTAGAAATGAAGGTTGTGATAATACACATAATCCTGAATTTACTTCGTGTGAATTTTATTGGGCATATGCT	8
KRS7TGC	TATGAAATTGGTAAAGTATTTAGAAATGAAGGTTGCGATAATACACATAATCCTGAATTTACTTCGTGTGAATTTTATTGGGCATATGCT	4
KRS7TGA	TATGAAATTGGTAAAGTATTTAGAAATGAAGGTTGAGATAATACACATAATCCTGAATTTACTTCGTGTGAATTTTATTGGGCATATGCT	3
KRS7TGG	TATGAAATTGGTAAAGTATTTAGAAATGAAGGTTGGGATAATACACATAATCCTGAATTTACTTCGTGTGAATTTTATTGGGCATATGCT	1
KRS7CGT	TATGAAATTGGTAAAGTATTTAGAAATGAAGGTCGTGATAATACACATAATCCTGAATTTACTTCGTGTGAATTTTATTGGGCATATGCT	3
KRS7CGC	TATGAAATTGGTAAAGTATTTAGAAATGAAGGTCGCGATAATACACATAATCCTGAATTTACTTCGTGTGAATTTTATTGGGCATATGCT	1
KRS7CGA	TATGAAATTGGTAAAGTATTTAGAAATGAAGGTCGAGATAATACACATAATCCTGAATTTACTTCGTGTGAATTTTATTGGGCATATGCT	1
KRS7CGG	TATGAAATTGGTAAAGTATTTAGAAATGAAGGTCGGGATAATACACATAATCCTGAATTTACTTCGTGTGAATTTTATTGGGCATATGCT	0
KRS7AGT	TATGAAATTGGTAAAGTATTTAGAAATGAAGGTAGTGATAATACACATAATCCTGAATTTACTTCGTGTGAATTTTATTGGGCATATGCT	1
KRS7AGC	TATGAAATTGGTAAAGTATTTAGAAATGAAGGTAGCGATAATACACATAATCCTGAATTTACTTCGTGTGAATTTTATTGGGCATATGCT	4
KRS7AGA	TATGAAATTGGTAAAGTATTTAGAAATGAAGGTAGAGATAATACACATAATCCTGAATTTACTTCGTGTGAATTTTATTGGGCATATGCT	34
KRS7AGG	TATGAAATTGGTAAAGTATTTAGAAATGAAGGTAGGGATAATACACATAATCCTGAATTTACTTCGTGTGAATTTTATTGGGCATATGCT	1
KRS7GGT	TATGAAATTGGTAAAGTATTTAGAAATGAAGGTGGTGATAATACACATAATCCTGAATTTACTTCGTGTGAATTTTATTGGGCATATGCT	3
KRS7GGC	TATGAAATTGGTAAAGTATTTAGAAATGAAGGTGGCGATAATACACATAATCCTGAATTTACTTCGTGTGAATTTTATTGGGCATATGCT	2
KRS7GGA	TATGAAATTGGTAAAGTATTTAGAAATGAAGGTGGAGATAATACACATAATCCTGAATTTACTTCGTGTGAATTTTATTGGGCATATGCT	3
KRS7GGG	TATGAAATTGGTAAAGTATTTAGAAATGAAGGTGGGGATAATACACATAATCCTGAATTTACTTCGTGTGAATTTTATTGGGCATATGCT	8
KRS8TTT	TATGAAATTGGTAAAGTATTTAGAAATGAAGGTATATTTAATACACATAATCCTGAATTTACTTCGTGTGAATTTTATTGGGCATATGCT	23
KRS8TTC	TATGAAATTGGTAAAGTATTTAGAAATGAAGGTATATTCAATACACATAATCCTGAATTTACTTCGTGTGAATTTTATTGGGCATATGCT	7
KRS8TTA	TATGAAATTGGTAAAGTATTTAGAAATGAAGGTATATTAAATACACATAATCCTGAATTTACTTCGTGTGAATTTTATTGGGCATATGCT	26
KRS8TTG	TATGAAATTGGTAAAGTATTTAGAAATGAAGGTATATTGAATACACATAATCCTGAATTTACTTCGTGTGAATTTTATTGGGCATATGCT	4
KRS8CTT	TATGAAATTGGTAAAGTATTTAGAAATGAAGGTATACTTAATACACATAATCCTGAATTTACTTCGTGTGAATTTTATTGGGCATATGCT	2
KRS8CTC	TATGAAATTGGTAAAGTATTTAGAAATGAAGGTATACTCAATACACATAATCCTGAATTTACTTCGTGTGAATTTTATTGGGCATATGCT	5
KRS8CTA	TATGAAATTGGTAAAGTATTTAGAAATGAAGGTATACTAAATACACATAATCCTGAATTTACTTCGTGTGAATTTTATTGGGCATATGCT	3
KRS8CTG	TATGAAATTGGTAAAGTATTTAGAAATGAAGGTATACTGAATACACATAATCCTGAATTTACTTCGTGTGAATTTTATTGGGCATATGCT	3
KRS8ATT	TATGAAATTGGTAAAGTATTTAGAAATGAAGGTATAATTAATACACATAATCCTGAATTTACTTCGTGTGAATTTTATTGGGCATATGCT	6
KRS8ATC	TATGAAATTGGTAAAGTATTTAGAAATGAAGGTATAATCAATACACATAATCCTGAATTTACTTCGTGTGAATTTTATTGGGCATATGCT	8
KRS8ATA	TATGAAATTGGTAAAGTATTTAGAAATGAAGGTATAATAAATACACATAATCCTGAATTTACTTCGTGTGAATTTTATTGGGCATATGCT	16
KRS8ATG	TATGAAATTGGTAAAGTATTTAGAAATGAAGGTATAATGAATACACATAATCCTGAATTTACTTCGTGTGAATTTTATTGGGCATATGCT	7
KRS8GTT	TATGAAATTGGTAAAGTATTTAGAAATGAAGGTATAGTTAATACACATAATCCTGAATTTACTTCGTGTGAATTTTATTGGGCATATGCT	41
KRS8GTC	TATGAAATTGGTAAAGTATTTAGAAATGAAGGTATAGTCAATACACATAATCCTGAATTTACTTCGTGTGAATTTTATTGGGCATATGCT	3
KRS8GTA	TATGAAATTGGTAAAGTATTTAGAAATGAAGGTATAGTAAATACACATAATCCTGAATTTACTTCGTGTGAATTTTATTGGGCATATGCT	5
KRS8GTG	TATGAAATTGGTAAAGTATTTAGAAATGAAGGTATAGTGAATACACATAATCCTGAATTTACTTCGTGTGAATTTTATTGGGCATATGCT	0
KRS8TCT	TATGAAATTGGTAAAGTATTTAGAAATGAAGGTATATCTAATACACATAATCCTGAATTTACTTCGTGTGAATTTTATTGGGCATATGCT	4
KRS8TCC	TATGAAATTGGTAAAGTATTTAGAAATGAAGGTATATCCAATACACATAATCCTGAATTTACTTCGTGTGAATTTTATTGGGCATATGCT	0
KRS8TCA	TATGAAATTGGTAAAGTATTTAGAAATGAAGGTATATCAAATACACATAATCCTGAATTTACTTCGTGTGAATTTTATTGGGCATATGCT	4
KRS8TCG	TATGAAATTGGTAAAGTATTTAGAAATGAAGGTATATCGAATACACATAATCCTGAATTTACTTCGTGTGAATTTTATTGGGCATATGCT	0
KRS8CCT	TATGAAATTGGTAAAGTATTTAGAAATGAAGGTATACCTAATACACATAATCCTGAATTTACTTCGTGTGAATTTTATTGGGCATATGCT	0
KRS8CCC	TATGAAATTGGTAAAGTATTTAGAAATGAAGGTATACCCAATACACATAATCCTGAATTTACTTCGTGTGAATTTTATTGGGCATATGCT	1
KRS8CCA	TATGAAATTGGTAAAGTATTTAGAAATGAAGGTATACCAAATACACATAATCCTGAATTTACTTCGTGTGAATTTTATTGGGCATATGCT	2
KRS8CCG	TATGAAATTGGTAAAGTATTTAGAAATGAAGGTATACCGAATACACATAATCCTGAATTTACTTCGTGTGAATTTTATTGGGCATATGCT	0
KRS8ACT	TATGAAATTGGTAAAGTATTTAGAAATGAAGGTATAACTAATACACATAATCCTGAATTTACTTCGTGTGAATTTTATTGGGCATATGCT	0
KRS8ACC	TATGAAATTGGTAAAGTATTTAGAAATGAAGGTATAACCAATACACATAATCCTGAATTTACTTCGTGTGAATTTTATTGGGCATATGCT	1
KRS8ACA	TATGAAATTGGTAAAGTATTTAGAAATGAAGGTATAACAAATACACATAATCCTGAATTTACTTCGTGTGAATTTTATTGGGCATATGCT	13
KRS8ACG	TATGAAATTGGTAAAGTATTTAGAAATGAAGGTATAACGAATACACATAATCCTGAATTTACTTCGTGTGAATTTTATTGGGCATATGCT	1
KRS8GCT	TATGAAATTGGTAAAGTATTTAGAAATGAAGGTATAGCTAATACACATAATCCTGAATTTACTTCGTGTGAATTTTATTGGGCATATGCT	20
KRS8GCC	TATGAAATTGGTAAAGTATTTAGAAATGAAGGTATAGCCAATACACATAATCCTGAATTTACTTCGTGTGAATTTTATTGGGCATATGCT	0
KRS8GCA	TATGAAATTGGTAAAGTATTTAGAAATGAAGGTATAGCAAATACACATAATCCTGAATTTACTTCGTGTGAATTTTATTGGGCATATGCT	3
KRS8GCG	TATGAAATTGGTAAAGTATTTAGAAATGAAGGTATAGCGAATACACATAATCCTGAATTTACTTCGTGTGAATTTTATTGGGCATATGCT	1
KRS8TAT	TATGAAATTGGTAAAGTATTTAGAAATGAAGGTATATATAATACACATAATCCTGAATTTACTTCGTGTGAATTTTATTGGGCATATGCT	16
KRS8TAC	TATGAAATTGGTAAAGTATTTAGAAATGAAGGTATATACAATACACATAATCCTGAATTTACTTCGTGTGAATTTTATTGGGCATATGCT	2
KRS8TAA	TATGAAATTGGTAAAGTATTTAGAAATGAAGGTATATAAAATACACATAATCCTGAATTTACTTCGTGTGAATTTTATTGGGCATATGCT	16
KRS8TAG	TATGAAATTGGTAAAGTATTTAGAAATGAAGGTATATAGAATACACATAATCCTGAATTTACTTCGTGTGAATTTTATTGGGCATATGCT	1
KRS8CAT	TATGAAATTGGTAAAGTATTTAGAAATGAAGGTATACATAATACACATAATCCTGAATTTACTTCGTGTGAATTTTATTGGGCATATGCT	83
KRS8CAC	TATGAAATTGGTAAAGTATTTAGAAATGAAGGTATACACAATACACATAATCCTGAATTTACTTCGTGTGAATTTTATTGGGCATATGCT	2
KRS8CAA	TATGAAATTGGTAAAGTATTTAGAAATGAAGGTATACAAAATACACATAATCCTGAATTTACTTCGTGTGAATTTTATTGGGCATATGCT	18
KRS8CAG	TATGAAATTGGTAAAGTATTTAGAAATGAAGGTATACAGAATACACATAATCCTGAATTTACTTCGTGTGAATTTTATTGGGCATATGCT	0
KRS8AAT	TATGAAATTGGTAAAGTATTTAGAAATGAAGGTATAAATAATACACATAATCCTGAATTTACTTCGTGTGAATTTTATTGGGCATATGCT	57
KRS8AAC	TATGAAATTGGTAAAGTATTTAGAAATGAAGGTATAAACAATACACATAATCCTGAATTTACTTCGTGTGAATTTTATTGGGCATATGCT	13
KRS8AAA	TATGAAATTGGTAAAGTATTTAGAAATGAAGGTATAAAAAATACACATAATCCTGAATTTACTTCGTGTGAATTTTATTGGGCATATGCT	43
KRS8AAG	TATGAAATTGGTAAAGTATTTAGAAATGAAGGTATAAAGAATACACATAATCCTGAATTTACTTCGTGTGAATTTTATTGGGCATATGCT	8
KRS8GAT	TATGAAATTGGTAAAGTATTTAGAAATGAAGGTATAGATAATACACATAATCCTGAATTTACTTCGTGTGAATTTTATTGGGCATATGCT	91560
KRS8GAC	TATGAAATTGGTAAAGTATTTAGAAATGAAGGTATAGACAATACACATAATCCTGAATTTACTTCGTGTGAATTTTATTGGGCATATGCT	183
KRS8GAA	TATGAAATTGGTAAAGTATTTAGAAATGAAGGTATAGAAAATACACATAATCCTGAATTTACTTCGTGTGAATTTTATTGGGCATATGCT	28
KRS8GAG	TATGAAATTGGTAAAGTATTTAGAAATGAAGGTATAGAGAATACACATAATCCTGAATTTACTTCGTGTGAATTTTATTGGGCATATGCT	7
KRS8TGT	TATGAAATTGGTAAAGTATTTAGAAATGAAGGTATATGTAATACACATAATCCTGAATTTACTTCGTGTGAATTTTATTGGGCATATGCT	3
KRS8TGC	TATGAAATTGGTAAAGTATTTAGAAATGAAGGTATATGCAATACACATAATCCTGAATTTACTTCGTGTGAATTTTATTGGGCATATGCT	2
KRS8TGA	TATGAAATTGGTAAAGTATTTAGAAATGAAGGTATATGAAATACACATAATCCTGAATTTACTTCGTGTGAATTTTATTGGGCATATGCT	7
KRS8TGG	TATGAAATTGGTAAAGTATTTAGAAATGAAGGTATATGGAATACACATAATCCTGAATTTACTTCGTGTGAATTTTATTGGGCATATGCT	0
KRS8CGT	TATGAAATTGGTAAAGTATTTAGAAATGAAGGTATACGTAATACACATAATCCTGAATTTACTTCGTGTGAATTTTATTGGGCATATGCT	2
KRS8CGC	TATGAAATTGGTAAAGTATTTAGAAATGAAGGTATACGCAATACACATAATCCTGAATTTACTTCGTGTGAATTTTATTGGGCATATGCT	0
KRS8CGA	TATGAAATTGGTAAAGTATTTAGAAATGAAGGTATACGAAATACACATAATCCTGAATTTACTTCGTGTGAATTTTATTGGGCATATGCT	0
KRS8CGG	TATGAAATTGGTAAAGTATTTAGAAATGAAGGTATACGGAATACACATAATCCTGAATTTACTTCGTGTGAATTTTATTGGGCATATGCT	0
KRS8AGT	TATGAAATTGGTAAAGTATTTAGAAATGAAGGTATAAGTAATACACATAATCCTGAATTTACTTCGTGTGAATTTTATTGGGCATATGCT	1
KRS8AGC	TATGAAATTGGTAAAGTATTTAGAAATGAAGGTATAAGCAATACACATAATCCTGAATTTACTTCGTGTGAATTTTATTGGGCATATGCT	0
KRS8AGA	TATGAAATTGGTAAAGTATTTAGAAATGAAGGTATAAGAAATACACATAATCCTGAATTTACTTCGTGTGAATTTTATTGGGCATATGCT	2
KRS8AGG	TATGAAATTGGTAAAGTATTTAGAAATGAAGGTATAAGGAATACACATAATCCTGAATTTACTTCGTGTGAATTTTATTGGGCATATGCT	0
KRS8GGT	TATGAAATTGGTAAAGTATTTAGAAATGAAGGTATAGGTAATACACATAATCCTGAATTTACTTCGTGTGAATTTTATTGGGCATATGCT	225
KRS8GGC	TATGAAATTGGTAAAGTATTTAGAAATGAAGGTATAGGCAATACACATAATCCTGAATTTACTTCGTGTGAATTTTATTGGGCATATGCT	0
KRS8GGA	TATGAAATTGGTAAAGTATTTAGAAATGAAGGTATAGGAAATACACATAATCCTGAATTTACTTCGTGTGAATTTTATTGGGCATATGCT	0
KRS8GGG	TATGAAATTGGTAAAGTATTTAGAAATGAAGGTATAGGGAATACACATAATCCTGAATTTACTTCGTGTGAATTTTATTGGGCATATGCT	0
KRS9TTT	TATGAAATTGGTAAAGTATTTAGAAATGAAGGTATAGATTTTACACATAATCCTGAATTTACTTCGTGTGAATTTTATTGGGCATATGCT	7588
KRS9TTC	TATGAAATTGGTAAAGTATTTAGAAATGAAGGTATAGATTTCACACATAATCCTGAATTTACTTCGTGTGAATTTTATTGGGCATATGCT	28
KRS9TTA	TATGAAATTGGTAAAGTATTTAGAAATGAAGGTATAGATTTAACACATAATCCTGAATTTACTTCGTGTGAATTTTATTGGGCATATGCT	47
KRS9TTG	TATGAAATTGGTAAAGTATTTAGAAATGAAGGTATAGATTTGACACATAATCCTGAATTTACTTCGTGTGAATTTTATTGGGCATATGCT	37
KRS9CTT	TATGAAATTGGTAAAGTATTTAGAAATGAAGGTATAGATCTTACACATAATCCTGAATTTACTTCGTGTGAATTTTATTGGGCATATGCT	3241
KRS9CTC	TATGAAATTGGTAAAGTATTTAGAAATGAAGGTATAGATCTCACACATAATCCTGAATTTACTTCGTGTGAATTTTATTGGGCATATGCT	4
KRS9CTA	TATGAAATTGGTAAAGTATTTAGAAATGAAGGTATAGATCTAACACATAATCCTGAATTTACTTCGTGTGAATTTTATTGGGCATATGCT	1217
KRS9CTG	TATGAAATTGGTAAAGTATTTAGAAATGAAGGTATAGATCTGACACATAATCCTGAATTTACTTCGTGTGAATTTTATTGGGCATATGCT	6
KRS9ATT	TATGAAATTGGTAAAGTATTTAGAAATGAAGGTATAGATATTACACATAATCCTGAATTTACTTCGTGTGAATTTTATTGGGCATATGCT	85
KRS9ATC	TATGAAATTGGTAAAGTATTTAGAAATGAAGGTATAGATATCACACATAATCCTGAATTTACTTCGTGTGAATTTTATTGGGCATATGCT	6
KRS9ATA	TATGAAATTGGTAAAGTATTTAGAAATGAAGGTATAGATATAACACATAATCCTGAATTTACTTCGTGTGAATTTTATTGGGCATATGCT	938
KRS9ATG	TATGAAATTGGTAAAGTATTTAGAAATGAAGGTATAGATATGACACATAATCCTGAATTTACTTCGTGTGAATTTTATTGGGCATATGCT	9
KRS9GTT	TATGAAATTGGTAAAGTATTTAGAAATGAAGGTATAGATGTTACACATAATCCTGAATTTACTTCGTGTGAATTTTATTGGGCATATGCT	14
KRS9GTC	TATGAAATTGGTAAAGTATTTAGAAATGAAGGTATAGATGTCACACATAATCCTGAATTTACTTCGTGTGAATTTTATTGGGCATATGCT	4
KRS9GTA	TATGAAATTGGTAAAGTATTTAGAAATGAAGGTATAGATGTAACACATAATCCTGAATTTACTTCGTGTGAATTTTATTGGGCATATGCT	11
KRS9GTG	TATGAAATTGGTAAAGTATTTAGAAATGAAGGTATAGATGTGACACATAATCCTGAATTTACTTCGTGTGAATTTTATTGGGCATATGCT	2
KRS9TCT	TATGAAATTGGTAAAGTATTTAGAAATGAAGGTATAGATTCTACACATAATCCTGAATTTACTTCGTGTGAATTTTATTGGGCATATGCT	32
KRS9TCC	TATGAAATTGGTAAAGTATTTAGAAATGAAGGTATAGATTCCACACATAATCCTGAATTTACTTCGTGTGAATTTTATTGGGCATATGCT	8
KRS9TCA	TATGAAATTGGTAAAGTATTTAGAAATGAAGGTATAGATTCAACACATAATCCTGAATTTACTTCGTGTGAATTTTATTGGGCATATGCT	20
KRS9TCG	TATGAAATTGGTAAAGTATTTAGAAATGAAGGTATAGATTCGACACATAATCCTGAATTTACTTCGTGTGAATTTTATTGGGCATATGCT	3
KRS9CCT	TATGAAATTGGTAAAGTATTTAGAAATGAAGGTATAGATCCTACACATAATCCTGAATTTACTTCGTGTGAATTTTATTGGGCATATGCT	1160
KRS9CCC	TATGAAATTGGTAAAGTATTTAGAAATGAAGGTATAGATCCCACACATAATCCTGAATTTACTTCGTGTGAATTTTATTGGGCATATGCT	2
KRS9CCA	TATGAAATTGGTAAAGTATTTAGAAATGAAGGTATAGATCCAACACATAATCCTGAATTTACTTCGTGTGAATTTTATTGGGCATATGCT	4
KRS9CCG	TATGAAATTGGTAAAGTATTTAGAAATGAAGGTATAGATCCGACACATAATCCTGAATTTACTTCGTGTGAATTTTATTGGGCATATGCT	0
KRS9ACT	TATGAAATTGGTAAAGTATTTAGAAATGAAGGTATAGATACTACACATAATCCTGAATTTACTTCGTGTGAATTTTATTGGGCATATGCT	21
KRS9ACC	TATGAAATTGGTAAAGTATTTAGAAATGAAGGTATAGATACCACACATAATCCTGAATTTACTTCGTGTGAATTTTATTGGGCATATGCT	2
KRS9ACA	TATGAAATTGGTAAAGTATTTAGAAATGAAGGTATAGATACAACACATAATCCTGAATTTACTTCGTGTGAATTTTATTGGGCATATGCT	59
KRS9ACG	TATGAAATTGGTAAAGTATTTAGAAATGAAGGTATAGATACGACACATAATCCTGAATTTACTTCGTGTGAATTTTATTGGGCATATGCT	0
KRS9GCT	TATGAAATTGGTAAAGTATTTAGAAATGAAGGTATAGATGCTACACATAATCCTGAATTTACTTCGTGTGAATTTTATTGGGCATATGCT	10
KRS9GCC	TATGAAATTGGTAAAGTATTTAGAAATGAAGGTATAGATGCCACACATAATCCTGAATTTACTTCGTGTGAATTTTATTGGGCATATGCT	0
KRS9GCA	TATGAAATTGGTAAAGTATTTAGAAATGAAGGTATAGATGCAACACATAATCCTGAATTTACTTCGTGTGAATTTTATTGGGCATATGCT	7
KRS9GCG	TATGAAATTGGTAAAGTATTTAGAAATGAAGGTATAGATGCGACACATAATCCTGAATTTACTTCGTGTGAATTTTATTGGGCATATGCT	0
KRS9TAT	TATGAAATTGGTAAAGTATTTAGAAATGAAGGTATAGATTATACACATAATCCTGAATTTACTTCGTGTGAATTTTATTGGGCATATGCT	76
KRS9TAC	TATGAAATTGGTAAAGTATTTAGAAATGAAGGTATAGATTACACACATAATCCTGAATTTACTTCGTGTGAATTTTATTGGGCATATGCT	9
KRS9TAA	TATGAAATTGGTAAAGTATTTAGAAATGAAGGTATAGATTAAACACATAATCCTGAATTTACTTCGTGTGAATTTTATTGGGCATATGCT	62
KRS9TAG	TATGAAATTGGTAAAGTATTTAGAAATGAAGGTATAGATTAGACACATAATCCTGAATTTACTTCGTGTGAATTTTATTGGGCATATGCT	0
KRS9CAT	TATGAAATTGGTAAAGTATTTAGAAATGAAGGTATAGATCATACACATAATCCTGAATTTACTTCGTGTGAATTTTATTGGGCATATGCT	35
KRS9CAC	TATGAAATTGGTAAAGTATTTAGAAATGAAGGTATAGATCACACACATAATCCTGAATTTACTTCGTGTGAATTTTATTGGGCATATGCT	24
KRS9CAA	TATGAAATTGGTAAAGTATTTAGAAATGAAGGTATAGATCAAACACATAATCCTGAATTTACTTCGTGTGAATTTTATTGGGCATATGCT	24
KRS9CAG	TATGAAATTGGTAAAGTATTTAGAAATGAAGGTATAGATCAGACACATAATCCTGAATTTACTTCGTGTGAATTTTATTGGGCATATGCT	5
KRS9AAT	TATGAAATTGGTAAAGTATTTAGAAATGAAGGTATAGATAATACACATAATCCTGAATTTACTTCGTGTGAATTTTATTGGGCATATGCT	91560
KRS9AAC	TATGAAATTGGTAAAGTATTTAGAAATGAAGGTATAGATAACACACATAATCCTGAATTTACTTCGTGTGAATTTTATTGGGCATATGCT	168
KRS9AAA	TATGAAATTGGTAAAGTATTTAGAAATGAAGGTATAGATAAAACACATAATCCTGAATTTACTTCGTGTGAATTTTATTGGGCATATGCT	186
KRS9AAG	TATGAAATTGGTAAAGTATTTAGAAATGAAGGTATAGATAAGACACATAATCCTGAATTTACTTCGTGTGAATTTTATTGGGCATATGCT	18
KRS9GAT	TATGAAATTGGTAAAGTATTTAGAAATGAAGGTATAGATGATACACATAATCCTGAATTTACTTCGTGTGAATTTTATTGGGCATATGCT	128
KRS9GAC	TATGAAATTGGTAAAGTATTTAGAAATGAAGGTATAGATGACACACATAATCCTGAATTTACTTCGTGTGAATTTTATTGGGCATATGCT	0
KRS9GAA	TATGAAATTGGTAAAGTATTTAGAAATGAAGGTATAGATGAAACACATAATCCTGAATTTACTTCGTGTGAATTTTATTGGGCATATGCT	8
KRS9GAG	TATGAAATTGGTAAAGTATTTAGAAATGAAGGTATAGATGAGACACATAATCCTGAATTTACTTCGTGTGAATTTTATTGGGCATATGCT	1
KRS9TGT	TATGAAATTGGTAAAGTATTTAGAAATGAAGGTATAGATTGTACACATAATCCTGAATTTACTTCGTGTGAATTTTATTGGGCATATGCT	27
KRS9TGC	TATGAAATTGGTAAAGTATTTAGAAATGAAGGTATAGATTGCACACATAATCCTGAATTTACTTCGTGTGAATTTTATTGGGCATATGCT	2
KRS9TGA	TATGAAATTGGTAAAGTATTTAGAAATGAAGGTATAGATTGAACACATAATCCTGAATTTACTTCGTGTGAATTTTATTGGGCATATGCT	10
KRS9TGG	TATGAAATTGGTAAAGTATTTAGAAATGAAGGTATAGATTGGACACATAATCCTGAATTTACTTCGTGTGAATTTTATTGGGCATATGCT	3
KRS9CGT	TATGAAATTGGTAAAGTATTTAGAAATGAAGGTATAGATCGTACACATAATCCTGAATTTACTTCGTGTGAATTTTATTGGGCATATGCT	3
KRS9CGC	TATGAAATTGGTAAAGTATTTAGAAATGAAGGTATAGATCGCACACATAATCCTGAATTTACTTCGTGTGAATTTTATTGGGCATATGCT	0
KRS9CGA	TATGAAATTGGTAAAGTATTTAGAAATGAAGGTATAGATCGAACACATAATCCTGAATTTACTTCGTGTGAATTTTATTGGGCATATGCT	1
KRS9CGG	TATGAAATTGGTAAAGTATTTAGAAATGAAGGTATAGATCGGACACATAATCCTGAATTTACTTCGTGTGAATTTTATTGGGCATATGCT	0
KRS9AGT	TATGAAATTGGTAAAGTATTTAGAAATGAAGGTATAGATAGTACACATAATCCTGAATTTACTTCGTGTGAATTTTATTGGGCATATGCT	196
KRS9AGC	TATGAAATTGGTAAAGTATTTAGAAATGAAGGTATAGATAGCACACATAATCCTGAATTTACTTCGTGTGAATTTTATTGGGCATATGCT	3
KRS9AGA	TATGAAATTGGTAAAGTATTTAGAAATGAAGGTATAGATAGAACACATAATCCTGAATTTACTTCGTGTGAATTTTATTGGGCATATGCT	10
KRS9AGG	TATGAAATTGGTAAAGTATTTAGAAATGAAGGTATAGATAGGACACATAATCCTGAATTTACTTCGTGTGAATTTTATTGGGCATATGCT	2
KRS9GGT	TATGAAATTGGTAAAGTATTTAGAAATGAAGGTATAGATGGTACACATAATCCTGAATTTACTTCGTGTGAATTTTATTGGGCATATGCT	1
KRS9GGC	TATGAAATTGGTAAAGTATTTAGAAATGAAGGTATAGATGGCACACATAATCCTGAATTTACTTCGTGTGAATTTTATTGGGCATATGCT	0
KRS9GGA	TATGAAATTGGTAAAGTATTTAGAAATGAAGGTATAGATGGAACACATAATCCTGAATTTACTTCGTGTGAATTTTATTGGGCATATGCT	0
KRS9GGG	TATGAAATTGGTAAAGTATTTAGAAATGAAGGTATAGATGGGACACATAATCCTGAATTTACTTCGTGTGAATTTTATTGGGCATATGCT	0
KRS10TTT	TATGAAATTGGTAAAGTATTTAGAAATGAAGGTATAGATAATTTTCATAATCCTGAATTTACTTCGTGTGAATTTTATTGGGCATATGCT	28
KRS10TTC	TATGAAATTGGTAAAGTATTTAGAAATGAAGGTATAGATAATTTCCATAATCCTGAATTTACTTCGTGTGAATTTTATTGGGCATATGCT	7
KRS10TTA	TATGAAATTGGTAAAGTATTTAGAAATGAAGGTATAGATAATTTACATAATCCTGAATTTACTTCGTGTGAATTTTATTGGGCATATGCT	323
KRS10TTG	TATGAAATTGGTAAAGTATTTAGAAATGAAGGTATAGATAATTTGCATAATCCTGAATTTACTTCGTGTGAATTTTATTGGGCATATGCT	14
KRS10CTT	TATGAAATTGGTAAAGTATTTAGAAATGAAGGTATAGATAATCTTCATAATCCTGAATTTACTTCGTGTGAATTTTATTGGGCATATGCT	2
KRS10CTC	TATGAAATTGGTAAAGTATTTAGAAATGAAGGTATAGATAATCTCCATAATCCTGAATTTACTTCGTGTGAATTTTATTGGGCATATGCT	2
KRS10CTA	TATGAAATTGGTAAAGTATTTAGAAATGAAGGTATAGATAATCTACATAATCCTGAATTTACTTCGTGTGAATTTTATTGGGCATATGCT	0
KRS10CTG	TATGAAATTGGTAAAGTATTTAGAAATGAAGGTATAGATAATCTGCATAATCCTGAATTTACTTCGTGTGAATTTTATTGGGCATATGCT	2
KRS10ATT	TATGAAATTGGTAAAGTATTTAGAAATGAAGGTATAGATAATATTCATAATCCTGAATTTACTTCGTGTGAATTTTATTGGGCATATGCT	14
KRS10ATC	TATGAAATTGGTAAAGTATTTAGAAATGAAGGTATAGATAATATCCATAATCCTGAATTTACTTCGTGTGAATTTTATTGGGCATATGCT	14
KRS10ATA	TATGAAATTGGTAAAGTATTTAGAAATGAAGGTATAGATAATATACATAATCCTGAATTTACTTCGTGTGAATTTTATTGGGCATATGCT	1599
KRS10ATG	TATGAAATTGGTAAAGTATTTAGAAATGAAGGTATAGATAATATGCATAATCCTGAATTTACTTCGTGTGAATTTTATTGGGCATATGCT	8
KRS10GTT	TATGAAATTGGTAAAGTATTTAGAAATGAAGGTATAGATAATGTTCATAATCCTGAATTTACTTCGTGTGAATTTTATTGGGCATATGCT	9
KRS10GTC	TATGAAATTGGTAAAGTATTTAGAAATGAAGGTATAGATAATGTCCATAATCCTGAATTTACTTCGTGTGAATTTTATTGGGCATATGCT	1
KRS10GTA	TATGAAATTGGTAAAGTATTTAGAAATGAAGGTATAGATAATGTACATAATCCTGAATTTACTTCGTGTGAATTTTATTGGGCATATGCT	7
KRS10GTG	TATGAAATTGGTAAAGTATTTAGAAATGAAGGTATAGATAATGTGCATAATCCTGAATTTACTTCGTGTGAATTTTATTGGGCATATGCT	7
KRS10TCT	TATGAAATTGGTAAAGTATTTAGAAATGAAGGTATAGATAATTCTCATAATCCTGAATTTACTTCGTGTGAATTTTATTGGGCATATGCT	8
KRS10TCC	TATGAAATTGGTAAAGTATTTAGAAATGAAGGTATAGATAATTCCCATAATCCTGAATTTACTTCGTGTGAATTTTATTGGGCATATGCT	8
KRS10TCA	TATGAAATTGGTAAAGTATTTAGAAATGAAGGTATAGATAATTCACATAATCCTGAATTTACTTCGTGTGAATTTTATTGGGCATATGCT	129
KRS10TCG	TATGAAATTGGTAAAGTATTTAGAAATGAAGGTATAGATAATTCGCATAATCCTGAATTTACTTCGTGTGAATTTTATTGGGCATATGCT	2
KRS10CCT	TATGAAATTGGTAAAGTATTTAGAAATGAAGGTATAGATAATCCTCATAATCCTGAATTTACTTCGTGTGAATTTTATTGGGCATATGCT	4
KRS10CCC	TATGAAATTGGTAAAGTATTTAGAAATGAAGGTATAGATAATCCCCATAATCCTGAATTTACTTCGTGTGAATTTTATTGGGCATATGCT	0
KRS10CCA	TATGAAATTGGTAAAGTATTTAGAAATGAAGGTATAGATAATCCACATAATCCTGAATTTACTTCGTGTGAATTTTATTGGGCATATGCT	108
KRS10CCG	TATGAAATTGGTAAAGTATTTAGAAATGAAGGTATAGATAATCCGCATAATCCTGAATTTACTTCGTGTGAATTTTATTGGGCATATGCT	1
KRS10ACT	TATGAAATTGGTAAAGTATTTAGAAATGAAGGTATAGATAATACTCATAATCCTGAATTTACTTCGTGTGAATTTTATTGGGCATATGCT	141
KRS10ACC	TATGAAATTGGTAAAGTATTTAGAAATGAAGGTATAGATAATACCCATAATCCTGAATTTACTTCGTGTGAATTTTATTGGGCATATGCT	48
KRS10ACA	TATGAAATTGGTAAAGTATTTAGAAATGAAGGTATAGATAATACACATAATCCTGAATTTACTTCGTGTGAATTTTATTGGGCATATGCT	91560
KRS10ACG	TATGAAATTGGTAAAGTATTTAGAAATGAAGGTATAGATAATACGCATAATCCTGAATTTACTTCGTGTGAATTTTATTGGGCATATGCT	305
KRS10GCT	TATGAAATTGGTAAAGTATTTAGAAATGAAGGTATAGATAATGCTCATAATCCTGAATTTACTTCGTGTGAATTTTATTGGGCATATGCT	1
KRS10GCC	TATGAAATTGGTAAAGTATTTAGAAATGAAGGTATAGATAATGCCCATAATCCTGAATTTACTTCGTGTGAATTTTATTGGGCATATGCT	0
KRS10GCA	TATGAAATTGGTAAAGTATTTAGAAATGAAGGTATAGATAATGCACATAATCCTGAATTTACTTCGTGTGAATTTTATTGGGCATATGCT	165
KRS10GCG	TATGAAATTGGTAAAGTATTTAGAAATGAAGGTATAGATAATGCGCATAATCCTGAATTTACTTCGTGTGAATTTTATTGGGCATATGCT	2
KRS10TAT	TATGAAATTGGTAAAGTATTTAGAAATGAAGGTATAGATAATTATCATAATCCTGAATTTACTTCGTGTGAATTTTATTGGGCATATGCT	57
KRS10TAC	TATGAAATTGGTAAAGTATTTAGAAATGAAGGTATAGATAATTACCATAATCCTGAATTTACTTCGTGTGAATTTTATTGGGCATATGCT	13
KRS10TAA	TATGAAATTGGTAAAGTATTTAGAAATGAAGGTATAGATAATTAACATAATCCTGAATTTACTTCGTGTGAATTTTATTGGGCATATGCT	27
KRS10TAG	TATGAAATTGGTAAAGTATTTAGAAATGAAGGTATAGATAATTAGCATAATCCTGAATTTACTTCGTGTGAATTTTATTGGGCATATGCT	5
KRS10CAT	TATGAAATTGGTAAAGTATTTAGAAATGAAGGTATAGATAATCATCATAATCCTGAATTTACTTCGTGTGAATTTTATTGGGCATATGCT	7
KRS10CAC	TATGAAATTGGTAAAGTATTTAGAAATGAAGGTATAGATAATCACCATAATCCTGAATTTACTTCGTGTGAATTTTATTGGGCATATGCT	5
KRS10CAA	TATGAAATTGGTAAAGTATTTAGAAATGAAGGTATAGATAATCAACATAATCCTGAATTTACTTCGTGTGAATTTTATTGGGCATATGCT	7
KRS10CAG	TATGAAATTGGTAAAGTATTTAGAAATGAAGGTATAGATAATCAGCATAATCCTGAATTTACTTCGTGTGAATTTTATTGGGCATATGCT	3
KRS10AAT	TATGAAATTGGTAAAGTATTTAGAAATGAAGGTATAGATAATAATCATAATCCTGAATTTACTTCGTGTGAATTTTATTGGGCATATGCT	21
KRS10AAC	TATGAAATTGGTAAAGTATTTAGAAATGAAGGTATAGATAATAACCATAATCCTGAATTTACTTCGTGTGAATTTTATTGGGCATATGCT	52
KRS10AAA	TATGAAATTGGTAAAGTATTTAGAAATGAAGGTATAGATAATAAACATAATCCTGAATTTACTTCGTGTGAATTTTATTGGGCATATGCT	129
KRS10AAG	TATGAAATTGGTAAAGTATTTAGAAATGAAGGTATAGATAATAAGCATAATCCTGAATTTACTTCGTGTGAATTTTATTGGGCATATGCT	17
KRS10GAT	TATGAAATTGGTAAAGTATTTAGAAATGAAGGTATAGATAATGATCATAATCCTGAATTTACTTCGTGTGAATTTTATTGGGCATATGCT	7
KRS10GAC	TATGAAATTGGTAAAGTATTTAGAAATGAAGGTATAGATAATGACCATAATCCTGAATTTACTTCGTGTGAATTTTATTGGGCATATGCT	10
KRS10GAA	TATGAAATTGGTAAAGTATTTAGAAATGAAGGTATAGATAATGAACATAATCCTGAATTTACTTCGTGTGAATTTTATTGGGCATATGCT	13
KRS10GAG	TATGAAATTGGTAAAGTATTTAGAAATGAAGGTATAGATAATGAGCATAATCCTGAATTTACTTCGTGTGAATTTTATTGGGCATATGCT	5
KRS10TGT	TATGAAATTGGTAAAGTATTTAGAAATGAAGGTATAGATAATTGTCATAATCCTGAATTTACTTCGTGTGAATTTTATTGGGCATATGCT	9
KRS10TGC	TATGAAATTGGTAAAGTATTTAGAAATGAAGGTATAGATAATTGCCATAATCCTGAATTTACTTCGTGTGAATTTTATTGGGCATATGCT	3
KRS10TGA	TATGAAATTGGTAAAGTATTTAGAAATGAAGGTATAGATAATTGACATAATCCTGAATTTACTTCGTGTGAATTTTATTGGGCATATGCT	7
KRS10TGG	TATGAAATTGGTAAAGTATTTAGAAATGAAGGTATAGATAATTGGCATAATCCTGAATTTACTTCGTGTGAATTTTATTGGGCATATGCT	2
KRS10CGT	TATGAAATTGGTAAAGTATTTAGAAATGAAGGTATAGATAATCGTCATAATCCTGAATTTACTTCGTGTGAATTTTATTGGGCATATGCT	2
KRS10CGC	TATGAAATTGGTAAAGTATTTAGAAATGAAGGTATAGATAATCGCCATAATCCTGAATTTACTTCGTGTGAATTTTATTGGGCATATGCT	0
KRS10CGA	TATGAAATTGGTAAAGTATTTAGAAATGAAGGTATAGATAATCGACATAATCCTGAATTTACTTCGTGTGAATTTTATTGGGCATATGCT	3
KRS10CGG	TATGAAATTGGTAAAGTATTTAGAAATGAAGGTATAGATAATCGGCATAATCCTGAATTTACTTCGTGTGAATTTTATTGGGCATATGCT	1
KRS10AGT	TATGAAATTGGTAAAGTATTTAGAAATGAAGGTATAGATAATAGTCATAATCCTGAATTTACTTCGTGTGAATTTTATTGGGCATATGCT	4
KRS10AGC	TATGAAATTGGTAAAGTATTTAGAAATGAAGGTATAGATAATAGCCATAATCCTGAATTTACTTCGTGTGAATTTTATTGGGCATATGCT	1
KRS10AGA	TATGAAATTGGTAAAGTATTTAGAAATGAAGGTATAGATAATAGACATAATCCTGAATTTACTTCGTGTGAATTTTATTGGGCATATGCT	107
KRS10AGG	TATGAAATTGGTAAAGTATTTAGAAATGAAGGTATAGATAATAGGCATAATCCTGAATTTACTTCGTGTGAATTTTATTGGGCATATGCT	3
KRS10GGT	TATGAAATTGGTAAAGTATTTAGAAATGAAGGTATAGATAATGGTCATAATCCTGAATTTACTTCGTGTGAATTTTATTGGGCATATGCT	10
KRS10GGC	TATGAAATTGGTAAAGTATTTAGAAATGAAGGTATAGATAATGGCCATAATCCTGAATTTACTTCGTGTGAATTTTATTGGGCATATGCT	1
KRS10GGA	TATGAAATTGGTAAAGTATTTAGAAATGAAGGTATAGATAATGGACATAATCCTGAATTTACTTCGTGTGAATTTTATTGGGCATATGCT	15
KRS10GGG	TATGAAATTGGTAAAGTATTTAGAAATGAAGGTATAGATAATGGGCATAATCCTGAATTTACTTCGTGTGAATTTTATTGGGCATATGCT	1
KRS11TTT	TATGAAATTGGTAAAGTATTTAGAAATGAAGGTATAGATAATACATTTAATCCTGAATTTACTTCGTGTGAATTTTATTGGGCATATGCT	4944
KRS11TTC	TATGAAATTGGTAAAGTATTTAGAAATGAAGGTATAGATAATACATTCAATCCTGAATTTACTTCGTGTGAATTTTATTGGGCATATGCT	8
KRS11TTA	TATGAAATTGGTAAAGTATTTAGAAATGAAGGTATAGATAATACATTAAATCCTGAATTTACTTCGTGTGAATTTTATTGGGCATATGCT	84
KRS11TTG	TATGAAATTGGTAAAGTATTTAGAAATGAAGGTATAGATAATACATTGAATCCTGAATTTACTTCGTGTGAATTTTATTGGGCATATGCT	81
KRS11CTT	TATGAAATTGGTAAAGTATTTAGAAATGAAGGTATAGATAATACACTTAATCCTGAATTTACTTCGTGTGAATTTTATTGGGCATATGCT	132
KRS11CTC	TATGAAATTGGTAAAGTATTTAGAAATGAAGGTATAGATAATACACTCAATCCTGAATTTACTTCGTGTGAATTTTATTGGGCATATGCT	0
KRS11CTA	TATGAAATTGGTAAAGTATTTAGAAATGAAGGTATAGATAATACACTAAATCCTGAATTTACTTCGTGTGAATTTTATTGGGCATATGCT	3
KRS11CTG	TATGAAATTGGTAAAGTATTTAGAAATGAAGGTATAGATAATACACTGAATCCTGAATTTACTTCGTGTGAATTTTATTGGGCATATGCT	2
KRS11ATT	TATGAAATTGGTAAAGTATTTAGAAATGAAGGTATAGATAATACAATTAATCCTGAATTTACTTCGTGTGAATTTTATTGGGCATATGCT	223
KRS11ATC	TATGAAATTGGTAAAGTATTTAGAAATGAAGGTATAGATAATACAATCAATCCTGAATTTACTTCGTGTGAATTTTATTGGGCATATGCT	4
KRS11ATA	TATGAAATTGGTAAAGTATTTAGAAATGAAGGTATAGATAATACAATAAATCCTGAATTTACTTCGTGTGAATTTTATTGGGCATATGCT	170
KRS11ATG	TATGAAATTGGTAAAGTATTTAGAAATGAAGGTATAGATAATACAATGAATCCTGAATTTACTTCGTGTGAATTTTATTGGGCATATGCT	2
KRS11GTT	TATGAAATTGGTAAAGTATTTAGAAATGAAGGTATAGATAATACAGTTAATCCTGAATTTACTTCGTGTGAATTTTATTGGGCATATGCT	3
KRS11GTC	TATGAAATTGGTAAAGTATTTAGAAATGAAGGTATAGATAATACAGTCAATCCTGAATTTACTTCGTGTGAATTTTATTGGGCATATGCT	13
KRS11GTA	TATGAAATTGGTAAAGTATTTAGAAATGAAGGTATAGATAATACAGTAAATCCTGAATTTACTTCGTGTGAATTTTATTGGGCATATGCT	2
KRS11GTG	TATGAAATTGGTAAAGTATTTAGAAATGAAGGTATAGATAATACAGTGAATCCTGAATTTACTTCGTGTGAATTTTATTGGGCATATGCT	0
KRS11TCT	TATGAAATTGGTAAAGTATTTAGAAATGAAGGTATAGATAATACATCTAATCCTGAATTTACTTCGTGTGAATTTTATTGGGCATATGCT	16
KRS11TCC	TATGAAATTGGTAAAGTATTTAGAAATGAAGGTATAGATAATACATCCAATCCTGAATTTACTTCGTGTGAATTTTATTGGGCATATGCT	1
KRS11TCA	TATGAAATTGGTAAAGTATTTAGAAATGAAGGTATAGATAATACATCAAATCCTGAATTTACTTCGTGTGAATTTTATTGGGCATATGCT	5552
KRS11TCG	TATGAAATTGGTAAAGTATTTAGAAATGAAGGTATAGATAATACATCGAATCCTGAATTTACTTCGTGTGAATTTTATTGGGCATATGCT	24
KRS11CCT	TATGAAATTGGTAAAGTATTTAGAAATGAAGGTATAGATAATACACCTAATCCTGAATTTACTTCGTGTGAATTTTATTGGGCATATGCT	14
KRS11CCC	TATGAAATTGGTAAAGTATTTAGAAATGAAGGTATAGATAATACACCCAATCCTGAATTTACTTCGTGTGAATTTTATTGGGCATATGCT	0
KRS11CCA	TATGAAATTGGTAAAGTATTTAGAAATGAAGGTATAGATAATACACCAAATCCTGAATTTACTTCGTGTGAATTTTATTGGGCATATGCT	27
KRS11CCG	TATGAAATTGGTAAAGTATTTAGAAATGAAGGTATAGATAATACACCGAATCCTGAATTTACTTCGTGTGAATTTTATTGGGCATATGCT	0
KRS11ACT	TATGAAATTGGTAAAGTATTTAGAAATGAAGGTATAGATAATACAACTAATCCTGAATTTACTTCGTGTGAATTTTATTGGGCATATGCT	5
KRS11ACC	TATGAAATTGGTAAAGTATTTAGAAATGAAGGTATAGATAATACAACCAATCCTGAATTTACTTCGTGTGAATTTTATTGGGCATATGCT	0
KRS11ACA	TATGAAATTGGTAAAGTATTTAGAAATGAAGGTATAGATAATACAACAAATCCTGAATTTACTTCGTGTGAATTTTATTGGGCATATGCT	29
KRS11ACG	TATGAAATTGGTAAAGTATTTAGAAATGAAGGTATAGATAATACAACGAATCCTGAATTTACTTCGTGTGAATTTTATTGGGCATATGCT	0
KRS11GCT	TATGAAATTGGTAAAGTATTTAGAAATGAAGGTATAGATAATACAGCTAATCCTGAATTTACTTCGTGTGAATTTTATTGGGCATATGCT	0
KRS11GCC	TATGAAATTGGTAAAGTATTTAGAAATGAAGGTATAGATAATACAGCCAATCCTGAATTTACTTCGTGTGAATTTTATTGGGCATATGCT	0
KRS11GCA	TATGAAATTGGTAAAGTATTTAGAAATGAAGGTATAGATAATACAGCAAATCCTGAATTTACTTCGTGTGAATTTTATTGGGCATATGCT	2
KRS11GCG	TATGAAATTGGTAAAGTATTTAGAAATGAAGGTATAGATAATACAGCGAATCCTGAATTTACTTCGTGTGAATTTTATTGGGCATATGCT	0
KRS11TAT	TATGAAATTGGTAAAGTATTTAGAAATGAAGGTATAGATAATACATATAATCCTGAATTTACTTCGTGTGAATTTTATTGGGCATATGCT	154
KRS11TAC	TATGAAATTGGTAAAGTATTTAGAAATGAAGGTATAGATAATACATACAATCCTGAATTTACTTCGTGTGAATTTTATTGGGCATATGCT	271
KRS11TAA	TATGAAATTGGTAAAGTATTTAGAAATGAAGGTATAGATAATACATAAAATCCTGAATTTACTTCGTGTGAATTTTATTGGGCATATGCT	1488
KRS11TAG	TATGAAATTGGTAAAGTATTTAGAAATGAAGGTATAGATAATACATAGAATCCTGAATTTACTTCGTGTGAATTTTATTGGGCATATGCT	253023
KRS11CAT	TATGAAATTGGTAAAGTATTTAGAAATGAAGGTATAGATAATACACATAATCCTGAATTTACTTCGTGTGAATTTTATTGGGCATATGCT	91560
KRS11CAC	TATGAAATTGGTAAAGTATTTAGAAATGAAGGTATAGATAATACACACAATCCTGAATTTACTTCGTGTGAATTTTATTGGGCATATGCT	104
KRS11CAA	TATGAAATTGGTAAAGTATTTAGAAATGAAGGTATAGATAATACACAAAATCCTGAATTTACTTCGTGTGAATTTTATTGGGCATATGCT	259
KRS11CAG	TATGAAATTGGTAAAGTATTTAGAAATGAAGGTATAGATAATACACAGAATCCTGAATTTACTTCGTGTGAATTTTATTGGGCATATGCT	447
KRS11AAT	TATGAAATTGGTAAAGTATTTAGAAATGAAGGTATAGATAATACAAATAATCCTGAATTTACTTCGTGTGAATTTTATTGGGCATATGCT	819
KRS11AAC	TATGAAATTGGTAAAGTATTTAGAAATGAAGGTATAGATAATACAAACAATCCTGAATTTACTTCGTGTGAATTTTATTGGGCATATGCT	505
KRS11AAA	TATGAAATTGGTAAAGTATTTAGAAATGAAGGTATAGATAATACAAAAAATCCTGAATTTACTTCGTGTGAATTTTATTGGGCATATGCT	13529
KRS11AAG	TATGAAATTGGTAAAGTATTTAGAAATGAAGGTATAGATAATACAAAGAATCCTGAATTTACTTCGTGTGAATTTTATTGGGCATATGCT	114
KRS11GAT	TATGAAATTGGTAAAGTATTTAGAAATGAAGGTATAGATAATACAGATAATCCTGAATTTACTTCGTGTGAATTTTATTGGGCATATGCT	557
KRS11GAC	TATGAAATTGGTAAAGTATTTAGAAATGAAGGTATAGATAATACAGACAATCCTGAATTTACTTCGTGTGAATTTTATTGGGCATATGCT	22
KRS11GAA	TATGAAATTGGTAAAGTATTTAGAAATGAAGGTATAGATAATACAGAAAATCCTGAATTTACTTCGTGTGAATTTTATTGGGCATATGCT	409
KRS11GAG	TATGAAATTGGTAAAGTATTTAGAAATGAAGGTATAGATAATACAGAGAATCCTGAATTTACTTCGTGTGAATTTTATTGGGCATATGCT	15
KRS11TGT	TATGAAATTGGTAAAGTATTTAGAAATGAAGGTATAGATAATACATGTAATCCTGAATTTACTTCGTGTGAATTTTATTGGGCATATGCT	2
KRS11TGC	TATGAAATTGGTAAAGTATTTAGAAATGAAGGTATAGATAATACATGCAATCCTGAATTTACTTCGTGTGAATTTTATTGGGCATATGCT	208
KRS11TGA	TATGAAATTGGTAAAGTATTTAGAAATGAAGGTATAGATAATACATGAAATCCTGAATTTACTTCGTGTGAATTTTATTGGGCATATGCT	513
KRS11TGG	TATGAAATTGGTAAAGTATTTAGAAATGAAGGTATAGATAATACATGGAATCCTGAATTTACTTCGTGTGAATTTTATTGGGCATATGCT	285
KRS11CGT	TATGAAATTGGTAAAGTATTTAGAAATGAAGGTATAGATAATACACGTAATCCTGAATTTACTTCGTGTGAATTTTATTGGGCATATGCT	209
KRS11CGC	TATGAAATTGGTAAAGTATTTAGAAATGAAGGTATAGATAATACACGCAATCCTGAATTTACTTCGTGTGAATTTTATTGGGCATATGCT	1
KRS11CGA	TATGAAATTGGTAAAGTATTTAGAAATGAAGGTATAGATAATACACGAAATCCTGAATTTACTTCGTGTGAATTTTATTGGGCATATGCT	0
KRS11CGG	TATGAAATTGGTAAAGTATTTAGAAATGAAGGTATAGATAATACACGGAATCCTGAATTTACTTCGTGTGAATTTTATTGGGCATATGCT	4
KRS11AGT	TATGAAATTGGTAAAGTATTTAGAAATGAAGGTATAGATAATACAAGTAATCCTGAATTTACTTCGTGTGAATTTTATTGGGCATATGCT	2
KRS11AGC	TATGAAATTGGTAAAGTATTTAGAAATGAAGGTATAGATAATACAAGCAATCCTGAATTTACTTCGTGTGAATTTTATTGGGCATATGCT	4
KRS11AGA	TATGAAATTGGTAAAGTATTTAGAAATGAAGGTATAGATAATACAAGAAATCCTGAATTTACTTCGTGTGAATTTTATTGGGCATATGCT	23
KRS11AGG	TATGAAATTGGTAAAGTATTTAGAAATGAAGGTATAGATAATACAAGGAATCCTGAATTTACTTCGTGTGAATTTTATTGGGCATATGCT	0
KRS11GGT	TATGAAATTGGTAAAGTATTTAGAAATGAAGGTATAGATAATACAGGTAATCCTGAATTTACTTCGTGTGAATTTTATTGGGCATATGCT	5
KRS11GGC	TATGAAATTGGTAAAGTATTTAGAAATGAAGGTATAGATAATACAGGCAATCCTGAATTTACTTCGTGTGAATTTTATTGGGCATATGCT	1
KRS11GGA	TATGAAATTGGTAAAGTATTTAGAAATGAAGGTATAGATAATACAGGAAATCCTGAATTTACTTCGTGTGAATTTTATTGGGCATATGCT	1
KRS11GGG	TATGAAATTGGTAAAGTATTTAGAAATGAAGGTATAGATAATACAGGGAATCCTGAATTTACTTCGTGTGAATTTTATTGGGCATATGCT	0
KRS12TTT	TATGAAATTGGTAAAGTATTTAGAAATGAAGGTATAGATAATACACATTTTCCTGAATTTACTTCGTGTGAATTTTATTGGGCATATGCT	9998
KRS12TTC	TATGAAATTGGTAAAGTATTTAGAAATGAAGGTATAGATAATACACATTTCCCTGAATTTACTTCGTGTGAATTTTATTGGGCATATGCT	6011
KRS12TTA	TATGAAATTGGTAAAGTATTTAGAAATGAAGGTATAGATAATACACATTTACCTGAATTTACTTCGTGTGAATTTTATTGGGCATATGCT	33903
KRS12TTG	TATGAAATTGGTAAAGTATTTAGAAATGAAGGTATAGATAATACACATTTGCCTGAATTTACTTCGTGTGAATTTTATTGGGCATATGCT	311
KRS12CTT	TATGAAATTGGTAAAGTATTTAGAAATGAAGGTATAGATAATACACATCTTCCTGAATTTACTTCGTGTGAATTTTATTGGGCATATGCT	41
KRS12CTC	TATGAAATTGGTAAAGTATTTAGAAATGAAGGTATAGATAATACACATCTCCCTGAATTTACTTCGTGTGAATTTTATTGGGCATATGCT	28
KRS12CTA	TATGAAATTGGTAAAGTATTTAGAAATGAAGGTATAGATAATACACATCTACCTGAATTTACTTCGTGTGAATTTTATTGGGCATATGCT	3225
KRS12CTG	TATGAAATTGGTAAAGTATTTAGAAATGAAGGTATAGATAATACACATCTGCCTGAATTTACTTCGTGTGAATTTTATTGGGCATATGCT	107
KRS12ATT	TATGAAATTGGTAAAGTATTTAGAAATGAAGGTATAGATAATACACATATTCCTGAATTTACTTCGTGTGAATTTTATTGGGCATATGCT	117
KRS12ATC	TATGAAATTGGTAAAGTATTTAGAAATGAAGGTATAGATAATACACATATCCCTGAATTTACTTCGTGTGAATTTTATTGGGCATATGCT	40
KRS12ATA	TATGAAATTGGTAAAGTATTTAGAAATGAAGGTATAGATAATACACATATACCTGAATTTACTTCGTGTGAATTTTATTGGGCATATGCT	533
KRS12ATG	TATGAAATTGGTAAAGTATTTAGAAATGAAGGTATAGATAATACACATATGCCTGAATTTACTTCGTGTGAATTTTATTGGGCATATGCT	23901
KRS12GTT	TATGAAATTGGTAAAGTATTTAGAAATGAAGGTATAGATAATACACATGTTCCTGAATTTACTTCGTGTGAATTTTATTGGGCATATGCT	3323
KRS12GTC	TATGAAATTGGTAAAGTATTTAGAAATGAAGGTATAGATAATACACATGTCCCTGAATTTACTTCGTGTGAATTTTATTGGGCATATGCT	1455
KRS12GTA	TATGAAATTGGTAAAGTATTTAGAAATGAAGGTATAGATAATACACATGTACCTGAATTTACTTCGTGTGAATTTTATTGGGCATATGCT	2912
KRS12GTG	TATGAAATTGGTAAAGTATTTAGAAATGAAGGTATAGATAATACACATGTGCCTGAATTTACTTCGTGTGAATTTTATTGGGCATATGCT	44
KRS12TCT	TATGAAATTGGTAAAGTATTTAGAAATGAAGGTATAGATAATACACATTCTCCTGAATTTACTTCGTGTGAATTTTATTGGGCATATGCT	5052
KRS12TCC	TATGAAATTGGTAAAGTATTTAGAAATGAAGGTATAGATAATACACATTCCCCTGAATTTACTTCGTGTGAATTTTATTGGGCATATGCT	36
KRS12TCA	TATGAAATTGGTAAAGTATTTAGAAATGAAGGTATAGATAATACACATTCACCTGAATTTACTTCGTGTGAATTTTATTGGGCATATGCT	111
KRS12TCG	TATGAAATTGGTAAAGTATTTAGAAATGAAGGTATAGATAATACACATTCGCCTGAATTTACTTCGTGTGAATTTTATTGGGCATATGCT	109
KRS12CCT	TATGAAATTGGTAAAGTATTTAGAAATGAAGGTATAGATAATACACATCCTCCTGAATTTACTTCGTGTGAATTTTATTGGGCATATGCT	21
KRS12CCC	TATGAAATTGGTAAAGTATTTAGAAATGAAGGTATAGATAATACACATCCCCCTGAATTTACTTCGTGTGAATTTTATTGGGCATATGCT	3
KRS12CCA	TATGAAATTGGTAAAGTATTTAGAAATGAAGGTATAGATAATACACATCCACCTGAATTTACTTCGTGTGAATTTTATTGGGCATATGCT	5
KRS12CCG	TATGAAATTGGTAAAGTATTTAGAAATGAAGGTATAGATAATACACATCCGCCTGAATTTACTTCGTGTGAATTTTATTGGGCATATGCT	5
KRS12ACT	TATGAAATTGGTAAAGTATTTAGAAATGAAGGTATAGATAATACACATACTCCTGAATTTACTTCGTGTGAATTTTATTGGGCATATGCT	186
KRS12ACC	TATGAAATTGGTAAAGTATTTAGAAATGAAGGTATAGATAATACACATACCCCTGAATTTACTTCGTGTGAATTTTATTGGGCATATGCT	15
KRS12ACA	TATGAAATTGGTAAAGTATTTAGAAATGAAGGTATAGATAATACACATACACCTGAATTTACTTCGTGTGAATTTTATTGGGCATATGCT	2731
KRS12ACG	TATGAAATTGGTAAAGTATTTAGAAATGAAGGTATAGATAATACACATACGCCTGAATTTACTTCGTGTGAATTTTATTGGGCATATGCT	1037
KRS12GCT	TATGAAATTGGTAAAGTATTTAGAAATGAAGGTATAGATAATACACATGCTCCTGAATTTACTTCGTGTGAATTTTATTGGGCATATGCT	50
KRS12GCC	TATGAAATTGGTAAAGTATTTAGAAATGAAGGTATAGATAATACACATGCCCCTGAATTTACTTCGTGTGAATTTTATTGGGCATATGCT	2
KRS12GCA	TATGAAATTGGTAAAGTATTTAGAAATGAAGGTATAGATAATACACATGCACCTGAATTTACTTCGTGTGAATTTTATTGGGCATATGCT	45
KRS12GCG	TATGAAATTGGTAAAGTATTTAGAAATGAAGGTATAGATAATACACATGCGCCTGAATTTACTTCGTGTGAATTTTATTGGGCATATGCT	2
KRS12TAT	TATGAAATTGGTAAAGTATTTAGAAATGAAGGTATAGATAATACACATTATCCTGAATTTACTTCGTGTGAATTTTATTGGGCATATGCT	1585
KRS12TAC	TATGAAATTGGTAAAGTATTTAGAAATGAAGGTATAGATAATACACATTACCCTGAATTTACTTCGTGTGAATTTTATTGGGCATATGCT	219
KRS12TAA	TATGAAATTGGTAAAGTATTTAGAAATGAAGGTATAGATAATACACATTAACCTGAATTTACTTCGTGTGAATTTTATTGGGCATATGCT	5569
KRS12TAG	TATGAAATTGGTAAAGTATTTAGAAATGAAGGTATAGATAATACACATTAGCCTGAATTTACTTCGTGTGAATTTTATTGGGCATATGCT	8
KRS12CAT	TATGAAATTGGTAAAGTATTTAGAAATGAAGGTATAGATAATACACATCATCCTGAATTTACTTCGTGTGAATTTTATTGGGCATATGCT	544
KRS12CAC	TATGAAATTGGTAAAGTATTTAGAAATGAAGGTATAGATAATACACATCACCCTGAATTTACTTCGTGTGAATTTTATTGGGCATATGCT	5
KRS12CAA	TATGAAATTGGTAAAGTATTTAGAAATGAAGGTATAGATAATACACATCAACCTGAATTTACTTCGTGTGAATTTTATTGGGCATATGCT	1062
KRS12CAG	TATGAAATTGGTAAAGTATTTAGAAATGAAGGTATAGATAATACACATCAGCCTGAATTTACTTCGTGTGAATTTTATTGGGCATATGCT	20
KRS12AAT	TATGAAATTGGTAAAGTATTTAGAAATGAAGGTATAGATAATACACATAATCCTGAATTTACTTCGTGTGAATTTTATTGGGCATATGCT	91560
KRS12AAC	TATGAAATTGGTAAAGTATTTAGAAATGAAGGTATAGATAATACACATAACCCTGAATTTACTTCGTGTGAATTTTATTGGGCATATGCT	3071
KRS12AAA	TATGAAATTGGTAAAGTATTTAGAAATGAAGGTATAGATAATACACATAAACCTGAATTTACTTCGTGTGAATTTTATTGGGCATATGCT	365797
KRS12AAG	TATGAAATTGGTAAAGTATTTAGAAATGAAGGTATAGATAATACACATAAGCCTGAATTTACTTCGTGTGAATTTTATTGGGCATATGCT	901
KRS12GAT	TATGAAATTGGTAAAGTATTTAGAAATGAAGGTATAGATAATACACATGATCCTGAATTTACTTCGTGTGAATTTTATTGGGCATATGCT	1115
KRS12GAC	TATGAAATTGGTAAAGTATTTAGAAATGAAGGTATAGATAATACACATGACCCTGAATTTACTTCGTGTGAATTTTATTGGGCATATGCT	181
KRS12GAA	TATGAAATTGGTAAAGTATTTAGAAATGAAGGTATAGATAATACACATGAACCTGAATTTACTTCGTGTGAATTTTATTGGGCATATGCT	202954
KRS12GAG	TATGAAATTGGTAAAGTATTTAGAAATGAAGGTATAGATAATACACATGAGCCTGAATTTACTTCGTGTGAATTTTATTGGGCATATGCT	1024
KRS12TGT	TATGAAATTGGTAAAGTATTTAGAAATGAAGGTATAGATAATACACATTGTCCTGAATTTACTTCGTGTGAATTTTATTGGGCATATGCT	115
KRS12TGC	TATGAAATTGGTAAAGTATTTAGAAATGAAGGTATAGATAATACACATTGCCCTGAATTTACTTCGTGTGAATTTTATTGGGCATATGCT	2
KRS12TGA	TATGAAATTGGTAAAGTATTTAGAAATGAAGGTATAGATAATACACATTGACCTGAATTTACTTCGTGTGAATTTTATTGGGCATATGCT	14
KRS12TGG	TATGAAATTGGTAAAGTATTTAGAAATGAAGGTATAGATAATACACATTGGCCTGAATTTACTTCGTGTGAATTTTATTGGGCATATGCT	1
KRS12CGT	TATGAAATTGGTAAAGTATTTAGAAATGAAGGTATAGATAATACACATCGTCCTGAATTTACTTCGTGTGAATTTTATTGGGCATATGCT	32
KRS12CGC	TATGAAATTGGTAAAGTATTTAGAAATGAAGGTATAGATAATACACATCGCCCTGAATTTACTTCGTGTGAATTTTATTGGGCATATGCT	0
KRS12CGA	TATGAAATTGGTAAAGTATTTAGAAATGAAGGTATAGATAATACACATCGACCTGAATTTACTTCGTGTGAATTTTATTGGGCATATGCT	2
KRS12CGG	TATGAAATTGGTAAAGTATTTAGAAATGAAGGTATAGATAATACACATCGGCCTGAATTTACTTCGTGTGAATTTTATTGGGCATATGCT	0
KRS12AGT	TATGAAATTGGTAAAGTATTTAGAAATGAAGGTATAGATAATACACATAGTCCTGAATTTACTTCGTGTGAATTTTATTGGGCATATGCT	515
KRS12AGC	TATGAAATTGGTAAAGTATTTAGAAATGAAGGTATAGATAATACACATAGCCCTGAATTTACTTCGTGTGAATTTTATTGGGCATATGCT	5
KRS12AGA	TATGAAATTGGTAAAGTATTTAGAAATGAAGGTATAGATAATACACATAGACCTGAATTTACTTCGTGTGAATTTTATTGGGCATATGCT	801
KRS12AGG	TATGAAATTGGTAAAGTATTTAGAAATGAAGGTATAGATAATACACATAGGCCTGAATTTACTTCGTGTGAATTTTATTGGGCATATGCT	7
KRS12GGT	TATGAAATTGGTAAAGTATTTAGAAATGAAGGTATAGATAATACACATGGTCCTGAATTTACTTCGTGTGAATTTTATTGGGCATATGCT	36399
KRS12GGC	TATGAAATTGGTAAAGTATTTAGAAATGAAGGTATAGATAATACACATGGCCCTGAATTTACTTCGTGTGAATTTTATTGGGCATATGCT	114
KRS12GGA	TATGAAATTGGTAAAGTATTTAGAAATGAAGGTATAGATAATACACATGGACCTGAATTTACTTCGTGTGAATTTTATTGGGCATATGCT	559
KRS12GGG	TATGAAATTGGTAAAGTATTTAGAAATGAAGGTATAGATAATACACATGGGCCTGAATTTACTTCGTGTGAATTTTATTGGGCATATGCT	27
KRS13TTT	TATGAAATTGGTAAAGTATTTAGAAATGAAGGTATAGATAATACACATAATTTTGAATTTACTTCGTGTGAATTTTATTGGGCATATGCT	67
KRS13TTC	TATGAAATTGGTAAAGTATTTAGAAATGAAGGTATAGATAATACACATAATTTCGAATTTACTTCGTGTGAATTTTATTGGGCATATGCT	3801
KRS13TTA	TATGAAATTGGTAAAGTATTTAGAAATGAAGGTATAGATAATACACATAATTTAGAATTTACTTCGTGTGAATTTTATTGGGCATATGCT	262
KRS13TTG	TATGAAATTGGTAAAGTATTTAGAAATGAAGGTATAGATAATACACATAATTTGGAATTTACTTCGTGTGAATTTTATTGGGCATATGCT	163
KRS13CTT	TATGAAATTGGTAAAGTATTTAGAAATGAAGGTATAGATAATACACATAATCTTGAATTTACTTCGTGTGAATTTTATTGGGCATATGCT	60
KRS13CTC	TATGAAATTGGTAAAGTATTTAGAAATGAAGGTATAGATAATACACATAATCTCGAATTTACTTCGTGTGAATTTTATTGGGCATATGCT	12
KRS13CTA	TATGAAATTGGTAAAGTATTTAGAAATGAAGGTATAGATAATACACATAATCTAGAATTTACTTCGTGTGAATTTTATTGGGCATATGCT	84
KRS13CTG	TATGAAATTGGTAAAGTATTTAGAAATGAAGGTATAGATAATACACATAATCTGGAATTTACTTCGTGTGAATTTTATTGGGCATATGCT	4
KRS13ATT	TATGAAATTGGTAAAGTATTTAGAAATGAAGGTATAGATAATACACATAATATTGAATTTACTTCGTGTGAATTTTATTGGGCATATGCT	37
KRS13ATC	TATGAAATTGGTAAAGTATTTAGAAATGAAGGTATAGATAATACACATAATATCGAATTTACTTCGTGTGAATTTTATTGGGCATATGCT	6
KRS13ATA	TATGAAATTGGTAAAGTATTTAGAAATGAAGGTATAGATAATACACATAATATAGAATTTACTTCGTGTGAATTTTATTGGGCATATGCT	365
KRS13ATG	TATGAAATTGGTAAAGTATTTAGAAATGAAGGTATAGATAATACACATAATATGGAATTTACTTCGTGTGAATTTTATTGGGCATATGCT	127
KRS13GTT	TATGAAATTGGTAAAGTATTTAGAAATGAAGGTATAGATAATACACATAATGTTGAATTTACTTCGTGTGAATTTTATTGGGCATATGCT	161
KRS13GTC	TATGAAATTGGTAAAGTATTTAGAAATGAAGGTATAGATAATACACATAATGTCGAATTTACTTCGTGTGAATTTTATTGGGCATATGCT	2
KRS13GTA	TATGAAATTGGTAAAGTATTTAGAAATGAAGGTATAGATAATACACATAATGTAGAATTTACTTCGTGTGAATTTTATTGGGCATATGCT	201
KRS13GTG	TATGAAATTGGTAAAGTATTTAGAAATGAAGGTATAGATAATACACATAATGTGGAATTTACTTCGTGTGAATTTTATTGGGCATATGCT	7
KRS13TCT	TATGAAATTGGTAAAGTATTTAGAAATGAAGGTATAGATAATACACATAATTCTGAATTTACTTCGTGTGAATTTTATTGGGCATATGCT	187
KRS13TCC	TATGAAATTGGTAAAGTATTTAGAAATGAAGGTATAGATAATACACATAATTCCGAATTTACTTCGTGTGAATTTTATTGGGCATATGCT	12
KRS13TCA	TATGAAATTGGTAAAGTATTTAGAAATGAAGGTATAGATAATACACATAATTCAGAATTTACTTCGTGTGAATTTTATTGGGCATATGCT	185
KRS13TCG	TATGAAATTGGTAAAGTATTTAGAAATGAAGGTATAGATAATACACATAATTCGGAATTTACTTCGTGTGAATTTTATTGGGCATATGCT	0
KRS13CCT	TATGAAATTGGTAAAGTATTTAGAAATGAAGGTATAGATAATACACATAATCCTGAATTTACTTCGTGTGAATTTTATTGGGCATATGCT	91560
KRS13CCC	TATGAAATTGGTAAAGTATTTAGAAATGAAGGTATAGATAATACACATAATCCCGAATTTACTTCGTGTGAATTTTATTGGGCATATGCT	215
KRS13CCA	TATGAAATTGGTAAAGTATTTAGAAATGAAGGTATAGATAATACACATAATCCAGAATTTACTTCGTGTGAATTTTATTGGGCATATGCT	68
KRS13CCG	TATGAAATTGGTAAAGTATTTAGAAATGAAGGTATAGATAATACACATAATCCGGAATTTACTTCGTGTGAATTTTATTGGGCATATGCT	13
KRS13ACT	TATGAAATTGGTAAAGTATTTAGAAATGAAGGTATAGATAATACACATAATACTGAATTTACTTCGTGTGAATTTTATTGGGCATATGCT	410
KRS13ACC	TATGAAATTGGTAAAGTATTTAGAAATGAAGGTATAGATAATACACATAATACCGAATTTACTTCGTGTGAATTTTATTGGGCATATGCT	2
KRS13ACA	TATGAAATTGGTAAAGTATTTAGAAATGAAGGTATAGATAATACACATAATACAGAATTTACTTCGTGTGAATTTTATTGGGCATATGCT	1338
KRS13ACG	TATGAAATTGGTAAAGTATTTAGAAATGAAGGTATAGATAATACACATAATACGGAATTTACTTCGTGTGAATTTTATTGGGCATATGCT	13
KRS13GCT	TATGAAATTGGTAAAGTATTTAGAAATGAAGGTATAGATAATACACATAATGCTGAATTTACTTCGTGTGAATTTTATTGGGCATATGCT	248
KRS13GCC	TATGAAATTGGTAAAGTATTTAGAAATGAAGGTATAGATAATACACATAATGCCGAATTTACTTCGTGTGAATTTTATTGGGCATATGCT	1
KRS13GCA	TATGAAATTGGTAAAGTATTTAGAAATGAAGGTATAGATAATACACATAATGCAGAATTTACTTCGTGTGAATTTTATTGGGCATATGCT	6
KRS13GCG	TATGAAATTGGTAAAGTATTTAGAAATGAAGGTATAGATAATACACATAATGCGGAATTTACTTCGTGTGAATTTTATTGGGCATATGCT	2
KRS13TAT	TATGAAATTGGTAAAGTATTTAGAAATGAAGGTATAGATAATACACATAATTATGAATTTACTTCGTGTGAATTTTATTGGGCATATGCT	23
KRS13TAC	TATGAAATTGGTAAAGTATTTAGAAATGAAGGTATAGATAATACACATAATTACGAATTTACTTCGTGTGAATTTTATTGGGCATATGCT	8
KRS13TAA	TATGAAATTGGTAAAGTATTTAGAAATGAAGGTATAGATAATACACATAATTAAGAATTTACTTCGTGTGAATTTTATTGGGCATATGCT	171
KRS13TAG	TATGAAATTGGTAAAGTATTTAGAAATGAAGGTATAGATAATACACATAATTAGGAATTTACTTCGTGTGAATTTTATTGGGCATATGCT	2
KRS13CAT	TATGAAATTGGTAAAGTATTTAGAAATGAAGGTATAGATAATACACATAATCATGAATTTACTTCGTGTGAATTTTATTGGGCATATGCT	422
KRS13CAC	TATGAAATTGGTAAAGTATTTAGAAATGAAGGTATAGATAATACACATAATCACGAATTTACTTCGTGTGAATTTTATTGGGCATATGCT	127
KRS13CAA	TATGAAATTGGTAAAGTATTTAGAAATGAAGGTATAGATAATACACATAATCAAGAATTTACTTCGTGTGAATTTTATTGGGCATATGCT	14
KRS13CAG	TATGAAATTGGTAAAGTATTTAGAAATGAAGGTATAGATAATACACATAATCAGGAATTTACTTCGTGTGAATTTTATTGGGCATATGCT	2
KRS13AAT	TATGAAATTGGTAAAGTATTTAGAAATGAAGGTATAGATAATACACATAATAATGAATTTACTTCGTGTGAATTTTATTGGGCATATGCT	196
KRS13AAC	TATGAAATTGGTAAAGTATTTAGAAATGAAGGTATAGATAATACACATAATAACGAATTTACTTCGTGTGAATTTTATTGGGCATATGCT	23
KRS13AAA	TATGAAATTGGTAAAGTATTTAGAAATGAAGGTATAGATAATACACATAATAAAGAATTTACTTCGTGTGAATTTTATTGGGCATATGCT	35
KRS13AAG	TATGAAATTGGTAAAGTATTTAGAAATGAAGGTATAGATAATACACATAATAAGGAATTTACTTCGTGTGAATTTTATTGGGCATATGCT	1
KRS13GAT	TATGAAATTGGTAAAGTATTTAGAAATGAAGGTATAGATAATACACATAATGATGAATTTACTTCGTGTGAATTTTATTGGGCATATGCT	55
KRS13GAC	TATGAAATTGGTAAAGTATTTAGAAATGAAGGTATAGATAATACACATAATGACGAATTTACTTCGTGTGAATTTTATTGGGCATATGCT	5
KRS13GAA	TATGAAATTGGTAAAGTATTTAGAAATGAAGGTATAGATAATACACATAATGAAGAATTTACTTCGTGTGAATTTTATTGGGCATATGCT	124
KRS13GAG	TATGAAATTGGTAAAGTATTTAGAAATGAAGGTATAGATAATACACATAATGAGGAATTTACTTCGTGTGAATTTTATTGGGCATATGCT	0
KRS13TGT	TATGAAATTGGTAAAGTATTTAGAAATGAAGGTATAGATAATACACATAATTGTGAATTTACTTCGTGTGAATTTTATTGGGCATATGCT	36
KRS13TGC	TATGAAATTGGTAAAGTATTTAGAAATGAAGGTATAGATAATACACATAATTGCGAATTTACTTCGTGTGAATTTTATTGGGCATATGCT	10
KRS13TGA	TATGAAATTGGTAAAGTATTTAGAAATGAAGGTATAGATAATACACATAATTGAGAATTTACTTCGTGTGAATTTTATTGGGCATATGCT	2
KRS13TGG	TATGAAATTGGTAAAGTATTTAGAAATGAAGGTATAGATAATACACATAATTGGGAATTTACTTCGTGTGAATTTTATTGGGCATATGCT	2
KRS13CGT	TATGAAATTGGTAAAGTATTTAGAAATGAAGGTATAGATAATACACATAATCGTGAATTTACTTCGTGTGAATTTTATTGGGCATATGCT	113
KRS13CGC	TATGAAATTGGTAAAGTATTTAGAAATGAAGGTATAGATAATACACATAATCGCGAATTTACTTCGTGTGAATTTTATTGGGCATATGCT	0
KRS13CGA	TATGAAATTGGTAAAGTATTTAGAAATGAAGGTATAGATAATACACATAATCGAGAATTTACTTCGTGTGAATTTTATTGGGCATATGCT	2
KRS13CGG	TATGAAATTGGTAAAGTATTTAGAAATGAAGGTATAGATAATACACATAATCGGGAATTTACTTCGTGTGAATTTTATTGGGCATATGCT	0
KRS13AGT	TATGAAATTGGTAAAGTATTTAGAAATGAAGGTATAGATAATACACATAATAGTGAATTTACTTCGTGTGAATTTTATTGGGCATATGCT	139
KRS13AGC	TATGAAATTGGTAAAGTATTTAGAAATGAAGGTATAGATAATACACATAATAGCGAATTTACTTCGTGTGAATTTTATTGGGCATATGCT	21
KRS13AGA	TATGAAATTGGTAAAGTATTTAGAAATGAAGGTATAGATAATACACATAATAGAGAATTTACTTCGTGTGAATTTTATTGGGCATATGCT	4
KRS13AGG	TATGAAATTGGTAAAGTATTTAGAAATGAAGGTATAGATAATACACATAATAGGGAATTTACTTCGTGTGAATTTTATTGGGCATATGCT	0
KRS13GGT	TATGAAATTGGTAAAGTATTTAGAAATGAAGGTATAGATAATACACATAATGGTGAATTTACTTCGTGTGAATTTTATTGGGCATATGCT	5
KRS13GGC	TATGAAATTGGTAAAGTATTTAGAAATGAAGGTATAGATAATACACATAATGGCGAATTTACTTCGTGTGAATTTTATTGGGCATATGCT	0
KRS13GGA	TATGAAATTGGTAAAGTATTTAGAAATGAAGGTATAGATAATACACATAATGGAGAATTTACTTCGTGTGAATTTTATTGGGCATATGCT	8
KRS13GGG	TATGAAATTGGTAAAGTATTTAGAAATGAAGGTATAGATAATACACATAATGGGGAATTTACTTCGTGTGAATTTTATTGGGCATATGCT	7
KRS14TTT	TATGAAATTGGTAAAGTATTTAGAAATGAAGGTATAGATAATACACATAATCCTTTTTTTACTTCGTGTGAATTTTATTGGGCATATGCT	2
KRS14TTC	TATGAAATTGGTAAAGTATTTAGAAATGAAGGTATAGATAATACACATAATCCTTTCTTTACTTCGTGTGAATTTTATTGGGCATATGCT	1
KRS14TTA	TATGAAATTGGTAAAGTATTTAGAAATGAAGGTATAGATAATACACATAATCCTTTATTTACTTCGTGTGAATTTTATTGGGCATATGCT	7
KRS14TTG	TATGAAATTGGTAAAGTATTTAGAAATGAAGGTATAGATAATACACATAATCCTTTGTTTACTTCGTGTGAATTTTATTGGGCATATGCT	3
KRS14CTT	TATGAAATTGGTAAAGTATTTAGAAATGAAGGTATAGATAATACACATAATCCTCTTTTTACTTCGTGTGAATTTTATTGGGCATATGCT	2
KRS14CTC	TATGAAATTGGTAAAGTATTTAGAAATGAAGGTATAGATAATACACATAATCCTCTCTTTACTTCGTGTGAATTTTATTGGGCATATGCT	3
KRS14CTA	TATGAAATTGGTAAAGTATTTAGAAATGAAGGTATAGATAATACACATAATCCTCTATTTACTTCGTGTGAATTTTATTGGGCATATGCT	3
KRS14CTG	TATGAAATTGGTAAAGTATTTAGAAATGAAGGTATAGATAATACACATAATCCTCTGTTTACTTCGTGTGAATTTTATTGGGCATATGCT	0
KRS14ATT	TATGAAATTGGTAAAGTATTTAGAAATGAAGGTATAGATAATACACATAATCCTATTTTTACTTCGTGTGAATTTTATTGGGCATATGCT	10
KRS14ATC	TATGAAATTGGTAAAGTATTTAGAAATGAAGGTATAGATAATACACATAATCCTATCTTTACTTCGTGTGAATTTTATTGGGCATATGCT	5
KRS14ATA	TATGAAATTGGTAAAGTATTTAGAAATGAAGGTATAGATAATACACATAATCCTATATTTACTTCGTGTGAATTTTATTGGGCATATGCT	31
KRS14ATG	TATGAAATTGGTAAAGTATTTAGAAATGAAGGTATAGATAATACACATAATCCTATGTTTACTTCGTGTGAATTTTATTGGGCATATGCT	69
KRS14GTT	TATGAAATTGGTAAAGTATTTAGAAATGAAGGTATAGATAATACACATAATCCTGTTTTTACTTCGTGTGAATTTTATTGGGCATATGCT	10
KRS14GTC	TATGAAATTGGTAAAGTATTTAGAAATGAAGGTATAGATAATACACATAATCCTGTCTTTACTTCGTGTGAATTTTATTGGGCATATGCT	5
KRS14GTA	TATGAAATTGGTAAAGTATTTAGAAATGAAGGTATAGATAATACACATAATCCTGTATTTACTTCGTGTGAATTTTATTGGGCATATGCT	99
KRS14GTG	TATGAAATTGGTAAAGTATTTAGAAATGAAGGTATAGATAATACACATAATCCTGTGTTTACTTCGTGTGAATTTTATTGGGCATATGCT	6
KRS14TCT	TATGAAATTGGTAAAGTATTTAGAAATGAAGGTATAGATAATACACATAATCCTTCTTTTACTTCGTGTGAATTTTATTGGGCATATGCT	46
KRS14TCC	TATGAAATTGGTAAAGTATTTAGAAATGAAGGTATAGATAATACACATAATCCTTCCTTTACTTCGTGTGAATTTTATTGGGCATATGCT	3
KRS14TCA	TATGAAATTGGTAAAGTATTTAGAAATGAAGGTATAGATAATACACATAATCCTTCATTTACTTCGTGTGAATTTTATTGGGCATATGCT	4
KRS14TCG	TATGAAATTGGTAAAGTATTTAGAAATGAAGGTATAGATAATACACATAATCCTTCGTTTACTTCGTGTGAATTTTATTGGGCATATGCT	1
KRS14CCT	TATGAAATTGGTAAAGTATTTAGAAATGAAGGTATAGATAATACACATAATCCTCCTTTTACTTCGTGTGAATTTTATTGGGCATATGCT	2
KRS14CCC	TATGAAATTGGTAAAGTATTTAGAAATGAAGGTATAGATAATACACATAATCCTCCCTTTACTTCGTGTGAATTTTATTGGGCATATGCT	0
KRS14CCA	TATGAAATTGGTAAAGTATTTAGAAATGAAGGTATAGATAATACACATAATCCTCCATTTACTTCGTGTGAATTTTATTGGGCATATGCT	1
KRS14CCG	TATGAAATTGGTAAAGTATTTAGAAATGAAGGTATAGATAATACACATAATCCTCCGTTTACTTCGTGTGAATTTTATTGGGCATATGCT	0
KRS14ACT	TATGAAATTGGTAAAGTATTTAGAAATGAAGGTATAGATAATACACATAATCCTACTTTTACTTCGTGTGAATTTTATTGGGCATATGCT	2
KRS14ACC	TATGAAATTGGTAAAGTATTTAGAAATGAAGGTATAGATAATACACATAATCCTACCTTTACTTCGTGTGAATTTTATTGGGCATATGCT	1
KRS14ACA	TATGAAATTGGTAAAGTATTTAGAAATGAAGGTATAGATAATACACATAATCCTACATTTACTTCGTGTGAATTTTATTGGGCATATGCT	358
KRS14ACG	TATGAAATTGGTAAAGTATTTAGAAATGAAGGTATAGATAATACACATAATCCTACGTTTACTTCGTGTGAATTTTATTGGGCATATGCT	0
KRS14GCT	TATGAAATTGGTAAAGTATTTAGAAATGAAGGTATAGATAATACACATAATCCTGCTTTTACTTCGTGTGAATTTTATTGGGCATATGCT	2
KRS14GCC	TATGAAATTGGTAAAGTATTTAGAAATGAAGGTATAGATAATACACATAATCCTGCCTTTACTTCGTGTGAATTTTATTGGGCATATGCT	1
KRS14GCA	TATGAAATTGGTAAAGTATTTAGAAATGAAGGTATAGATAATACACATAATCCTGCATTTACTTCGTGTGAATTTTATTGGGCATATGCT	17
KRS14GCG	TATGAAATTGGTAAAGTATTTAGAAATGAAGGTATAGATAATACACATAATCCTGCGTTTACTTCGTGTGAATTTTATTGGGCATATGCT	2
KRS14TAT	TATGAAATTGGTAAAGTATTTAGAAATGAAGGTATAGATAATACACATAATCCTTATTTTACTTCGTGTGAATTTTATTGGGCATATGCT	116
KRS14TAC	TATGAAATTGGTAAAGTATTTAGAAATGAAGGTATAGATAATACACATAATCCTTACTTTACTTCGTGTGAATTTTATTGGGCATATGCT	2
KRS14TAA	TATGAAATTGGTAAAGTATTTAGAAATGAAGGTATAGATAATACACATAATCCTTAATTTACTTCGTGTGAATTTTATTGGGCATATGCT	21
KRS14TAG	TATGAAATTGGTAAAGTATTTAGAAATGAAGGTATAGATAATACACATAATCCTTAGTTTACTTCGTGTGAATTTTATTGGGCATATGCT	2
KRS14CAT	TATGAAATTGGTAAAGTATTTAGAAATGAAGGTATAGATAATACACATAATCCTCATTTTACTTCGTGTGAATTTTATTGGGCATATGCT	9
KRS14CAC	TATGAAATTGGTAAAGTATTTAGAAATGAAGGTATAGATAATACACATAATCCTCACTTTACTTCGTGTGAATTTTATTGGGCATATGCT	0
KRS14CAA	TATGAAATTGGTAAAGTATTTAGAAATGAAGGTATAGATAATACACATAATCCTCAATTTACTTCGTGTGAATTTTATTGGGCATATGCT	72
KRS14CAG	TATGAAATTGGTAAAGTATTTAGAAATGAAGGTATAGATAATACACATAATCCTCAGTTTACTTCGTGTGAATTTTATTGGGCATATGCT	1
KRS14AAT	TATGAAATTGGTAAAGTATTTAGAAATGAAGGTATAGATAATACACATAATCCTAATTTTACTTCGTGTGAATTTTATTGGGCATATGCT	7
KRS14AAC	TATGAAATTGGTAAAGTATTTAGAAATGAAGGTATAGATAATACACATAATCCTAACTTTACTTCGTGTGAATTTTATTGGGCATATGCT	1
KRS14AAA	TATGAAATTGGTAAAGTATTTAGAAATGAAGGTATAGATAATACACATAATCCTAAATTTACTTCGTGTGAATTTTATTGGGCATATGCT	79
KRS14AAG	TATGAAATTGGTAAAGTATTTAGAAATGAAGGTATAGATAATACACATAATCCTAAGTTTACTTCGTGTGAATTTTATTGGGCATATGCT	0
KRS14GAT	TATGAAATTGGTAAAGTATTTAGAAATGAAGGTATAGATAATACACATAATCCTGATTTTACTTCGTGTGAATTTTATTGGGCATATGCT	261
KRS14GAC	TATGAAATTGGTAAAGTATTTAGAAATGAAGGTATAGATAATACACATAATCCTGACTTTACTTCGTGTGAATTTTATTGGGCATATGCT	37
KRS14GAA	TATGAAATTGGTAAAGTATTTAGAAATGAAGGTATAGATAATACACATAATCCTGAATTTACTTCGTGTGAATTTTATTGGGCATATGCT	91560
KRS14GAG	TATGAAATTGGTAAAGTATTTAGAAATGAAGGTATAGATAATACACATAATCCTGAGTTTACTTCGTGTGAATTTTATTGGGCATATGCT	218
KRS14TGT	TATGAAATTGGTAAAGTATTTAGAAATGAAGGTATAGATAATACACATAATCCTTGTTTTACTTCGTGTGAATTTTATTGGGCATATGCT	6
KRS14TGC	TATGAAATTGGTAAAGTATTTAGAAATGAAGGTATAGATAATACACATAATCCTTGCTTTACTTCGTGTGAATTTTATTGGGCATATGCT	1
KRS14TGA	TATGAAATTGGTAAAGTATTTAGAAATGAAGGTATAGATAATACACATAATCCTTGATTTACTTCGTGTGAATTTTATTGGGCATATGCT	6
KRS14TGG	TATGAAATTGGTAAAGTATTTAGAAATGAAGGTATAGATAATACACATAATCCTTGGTTTACTTCGTGTGAATTTTATTGGGCATATGCT	116
KRS14CGT	TATGAAATTGGTAAAGTATTTAGAAATGAAGGTATAGATAATACACATAATCCTCGTTTTACTTCGTGTGAATTTTATTGGGCATATGCT	4
KRS14CGC	TATGAAATTGGTAAAGTATTTAGAAATGAAGGTATAGATAATACACATAATCCTCGCTTTACTTCGTGTGAATTTTATTGGGCATATGCT	3
KRS14CGA	TATGAAATTGGTAAAGTATTTAGAAATGAAGGTATAGATAATACACATAATCCTCGATTTACTTCGTGTGAATTTTATTGGGCATATGCT	1
KRS14CGG	TATGAAATTGGTAAAGTATTTAGAAATGAAGGTATAGATAATACACATAATCCTCGGTTTACTTCGTGTGAATTTTATTGGGCATATGCT	0
KRS14AGT	TATGAAATTGGTAAAGTATTTAGAAATGAAGGTATAGATAATACACATAATCCTAGTTTTACTTCGTGTGAATTTTATTGGGCATATGCT	21
KRS14AGC	TATGAAATTGGTAAAGTATTTAGAAATGAAGGTATAGATAATACACATAATCCTAGCTTTACTTCGTGTGAATTTTATTGGGCATATGCT	172
KRS14AGA	TATGAAATTGGTAAAGTATTTAGAAATGAAGGTATAGATAATACACATAATCCTAGATTTACTTCGTGTGAATTTTATTGGGCATATGCT	5
KRS14AGG	TATGAAATTGGTAAAGTATTTAGAAATGAAGGTATAGATAATACACATAATCCTAGGTTTACTTCGTGTGAATTTTATTGGGCATATGCT	1
KRS14GGT	TATGAAATTGGTAAAGTATTTAGAAATGAAGGTATAGATAATACACATAATCCTGGTTTTACTTCGTGTGAATTTTATTGGGCATATGCT	4
KRS14GGC	TATGAAATTGGTAAAGTATTTAGAAATGAAGGTATAGATAATACACATAATCCTGGCTTTACTTCGTGTGAATTTTATTGGGCATATGCT	3
KRS14GGA	TATGAAATTGGTAAAGTATTTAGAAATGAAGGTATAGATAATACACATAATCCTGGATTTACTTCGTGTGAATTTTATTGGGCATATGCT	233
KRS14GGG	TATGAAATTGGTAAAGTATTTAGAAATGAAGGTATAGATAATACACATAATCCTGGGTTTACTTCGTGTGAATTTTATTGGGCATATGCT	0
KRS15TTT	TATGAAATTGGTAAAGTATTTAGAAATGAAGGTATAGATAATACACATAATCCTGAATTTACTTCGTGTGAATTTTATTGGGCATATGCT	91560
KRS15TTC	TATGAAATTGGTAAAGTATTTAGAAATGAAGGTATAGATAATACACATAATCCTGAATTCACTTCGTGTGAATTTTATTGGGCATATGCT	619
KRS15TTA	TATGAAATTGGTAAAGTATTTAGAAATGAAGGTATAGATAATACACATAATCCTGAATTAACTTCGTGTGAATTTTATTGGGCATATGCT	40
KRS15TTG	TATGAAATTGGTAAAGTATTTAGAAATGAAGGTATAGATAATACACATAATCCTGAATTGACTTCGTGTGAATTTTATTGGGCATATGCT	12
KRS15CTT	TATGAAATTGGTAAAGTATTTAGAAATGAAGGTATAGATAATACACATAATCCTGAACTTACTTCGTGTGAATTTTATTGGGCATATGCT	228
KRS15CTC	TATGAAATTGGTAAAGTATTTAGAAATGAAGGTATAGATAATACACATAATCCTGAACTCACTTCGTGTGAATTTTATTGGGCATATGCT	48
KRS15CTA	TATGAAATTGGTAAAGTATTTAGAAATGAAGGTATAGATAATACACATAATCCTGAACTAACTTCGTGTGAATTTTATTGGGCATATGCT	5
KRS15CTG	TATGAAATTGGTAAAGTATTTAGAAATGAAGGTATAGATAATACACATAATCCTGAACTGACTTCGTGTGAATTTTATTGGGCATATGCT	3
KRS15ATT	TATGAAATTGGTAAAGTATTTAGAAATGAAGGTATAGATAATACACATAATCCTGAAATTACTTCGTGTGAATTTTATTGGGCATATGCT	10038
KRS15ATC	TATGAAATTGGTAAAGTATTTAGAAATGAAGGTATAGATAATACACATAATCCTGAAATCACTTCGTGTGAATTTTATTGGGCATATGCT	17
KRS15ATA	TATGAAATTGGTAAAGTATTTAGAAATGAAGGTATAGATAATACACATAATCCTGAAATAACTTCGTGTGAATTTTATTGGGCATATGCT	10
KRS15ATG	TATGAAATTGGTAAAGTATTTAGAAATGAAGGTATAGATAATACACATAATCCTGAAATGACTTCGTGTGAATTTTATTGGGCATATGCT	3
KRS15GTT	TATGAAATTGGTAAAGTATTTAGAAATGAAGGTATAGATAATACACATAATCCTGAAGTTACTTCGTGTGAATTTTATTGGGCATATGCT	62
KRS15GTC	TATGAAATTGGTAAAGTATTTAGAAATGAAGGTATAGATAATACACATAATCCTGAAGTCACTTCGTGTGAATTTTATTGGGCATATGCT	0
KRS15GTA	TATGAAATTGGTAAAGTATTTAGAAATGAAGGTATAGATAATACACATAATCCTGAAGTAACTTCGTGTGAATTTTATTGGGCATATGCT	1
KRS15GTG	TATGAAATTGGTAAAGTATTTAGAAATGAAGGTATAGATAATACACATAATCCTGAAGTGACTTCGTGTGAATTTTATTGGGCATATGCT	1
KRS15TCT	TATGAAATTGGTAAAGTATTTAGAAATGAAGGTATAGATAATACACATAATCCTGAATCTACTTCGTGTGAATTTTATTGGGCATATGCT	218
KRS15TCC	TATGAAATTGGTAAAGTATTTAGAAATGAAGGTATAGATAATACACATAATCCTGAATCCACTTCGTGTGAATTTTATTGGGCATATGCT	240
KRS15TCA	TATGAAATTGGTAAAGTATTTAGAAATGAAGGTATAGATAATACACATAATCCTGAATCAACTTCGTGTGAATTTTATTGGGCATATGCT	756
KRS15TCG	TATGAAATTGGTAAAGTATTTAGAAATGAAGGTATAGATAATACACATAATCCTGAATCGACTTCGTGTGAATTTTATTGGGCATATGCT	3
KRS15CCT	TATGAAATTGGTAAAGTATTTAGAAATGAAGGTATAGATAATACACATAATCCTGAACCTACTTCGTGTGAATTTTATTGGGCATATGCT	4
KRS15CCC	TATGAAATTGGTAAAGTATTTAGAAATGAAGGTATAGATAATACACATAATCCTGAACCCACTTCGTGTGAATTTTATTGGGCATATGCT	26
KRS15CCA	TATGAAATTGGTAAAGTATTTAGAAATGAAGGTATAGATAATACACATAATCCTGAACCAACTTCGTGTGAATTTTATTGGGCATATGCT	19
KRS15CCG	TATGAAATTGGTAAAGTATTTAGAAATGAAGGTATAGATAATACACATAATCCTGAACCGACTTCGTGTGAATTTTATTGGGCATATGCT	1
KRS15ACT	TATGAAATTGGTAAAGTATTTAGAAATGAAGGTATAGATAATACACATAATCCTGAAACTACTTCGTGTGAATTTTATTGGGCATATGCT	30
KRS15ACC	TATGAAATTGGTAAAGTATTTAGAAATGAAGGTATAGATAATACACATAATCCTGAAACCACTTCGTGTGAATTTTATTGGGCATATGCT	3
KRS15ACA	TATGAAATTGGTAAAGTATTTAGAAATGAAGGTATAGATAATACACATAATCCTGAAACAACTTCGTGTGAATTTTATTGGGCATATGCT	12468
KRS15ACG	TATGAAATTGGTAAAGTATTTAGAAATGAAGGTATAGATAATACACATAATCCTGAAACGACTTCGTGTGAATTTTATTGGGCATATGCT	51
KRS15GCT	TATGAAATTGGTAAAGTATTTAGAAATGAAGGTATAGATAATACACATAATCCTGAAGCTACTTCGTGTGAATTTTATTGGGCATATGCT	544
KRS15GCC	TATGAAATTGGTAAAGTATTTAGAAATGAAGGTATAGATAATACACATAATCCTGAAGCCACTTCGTGTGAATTTTATTGGGCATATGCT	2
KRS15GCA	TATGAAATTGGTAAAGTATTTAGAAATGAAGGTATAGATAATACACATAATCCTGAAGCAACTTCGTGTGAATTTTATTGGGCATATGCT	34
KRS15GCG	TATGAAATTGGTAAAGTATTTAGAAATGAAGGTATAGATAATACACATAATCCTGAAGCGACTTCGTGTGAATTTTATTGGGCATATGCT	57
KRS15TAT	TATGAAATTGGTAAAGTATTTAGAAATGAAGGTATAGATAATACACATAATCCTGAATATACTTCGTGTGAATTTTATTGGGCATATGCT	7287
KRS15TAC	TATGAAATTGGTAAAGTATTTAGAAATGAAGGTATAGATAATACACATAATCCTGAATACACTTCGTGTGAATTTTATTGGGCATATGCT	275241
KRS15TAA	TATGAAATTGGTAAAGTATTTAGAAATGAAGGTATAGATAATACACATAATCCTGAATAAACTTCGTGTGAATTTTATTGGGCATATGCT	22
KRS15TAG	TATGAAATTGGTAAAGTATTTAGAAATGAAGGTATAGATAATACACATAATCCTGAATAGACTTCGTGTGAATTTTATTGGGCATATGCT	141
KRS15CAT	TATGAAATTGGTAAAGTATTTAGAAATGAAGGTATAGATAATACACATAATCCTGAACATACTTCGTGTGAATTTTATTGGGCATATGCT	21492
KRS15CAC	TATGAAATTGGTAAAGTATTTAGAAATGAAGGTATAGATAATACACATAATCCTGAACACACTTCGTGTGAATTTTATTGGGCATATGCT	20317
KRS15CAA	TATGAAATTGGTAAAGTATTTAGAAATGAAGGTATAGATAATACACATAATCCTGAACAAACTTCGTGTGAATTTTATTGGGCATATGCT	27
KRS15CAG	TATGAAATTGGTAAAGTATTTAGAAATGAAGGTATAGATAATACACATAATCCTGAACAGACTTCGTGTGAATTTTATTGGGCATATGCT	27
KRS15AAT	TATGAAATTGGTAAAGTATTTAGAAATGAAGGTATAGATAATACACATAATCCTGAAAATACTTCGTGTGAATTTTATTGGGCATATGCT	16
KRS15AAC	TATGAAATTGGTAAAGTATTTAGAAATGAAGGTATAGATAATACACATAATCCTGAAAACACTTCGTGTGAATTTTATTGGGCATATGCT	92
KRS15AAA	TATGAAATTGGTAAAGTATTTAGAAATGAAGGTATAGATAATACACATAATCCTGAAAAAACTTCGTGTGAATTTTATTGGGCATATGCT	334
KRS15AAG	TATGAAATTGGTAAAGTATTTAGAAATGAAGGTATAGATAATACACATAATCCTGAAAAGACTTCGTGTGAATTTTATTGGGCATATGCT	4
KRS15GAT	TATGAAATTGGTAAAGTATTTAGAAATGAAGGTATAGATAATACACATAATCCTGAAGATACTTCGTGTGAATTTTATTGGGCATATGCT	16
KRS15GAC	TATGAAATTGGTAAAGTATTTAGAAATGAAGGTATAGATAATACACATAATCCTGAAGACACTTCGTGTGAATTTTATTGGGCATATGCT	38
KRS15GAA	TATGAAATTGGTAAAGTATTTAGAAATGAAGGTATAGATAATACACATAATCCTGAAGAAACTTCGTGTGAATTTTATTGGGCATATGCT	1076
KRS15GAG	TATGAAATTGGTAAAGTATTTAGAAATGAAGGTATAGATAATACACATAATCCTGAAGAGACTTCGTGTGAATTTTATTGGGCATATGCT	7
KRS15TGT	TATGAAATTGGTAAAGTATTTAGAAATGAAGGTATAGATAATACACATAATCCTGAATGTACTTCGTGTGAATTTTATTGGGCATATGCT	887
KRS15TGC	TATGAAATTGGTAAAGTATTTAGAAATGAAGGTATAGATAATACACATAATCCTGAATGCACTTCGTGTGAATTTTATTGGGCATATGCT	392
KRS15TGA	TATGAAATTGGTAAAGTATTTAGAAATGAAGGTATAGATAATACACATAATCCTGAATGAACTTCGTGTGAATTTTATTGGGCATATGCT	1
KRS15TGG	TATGAAATTGGTAAAGTATTTAGAAATGAAGGTATAGATAATACACATAATCCTGAATGGACTTCGTGTGAATTTTATTGGGCATATGCT	3352
KRS15CGT	TATGAAATTGGTAAAGTATTTAGAAATGAAGGTATAGATAATACACATAATCCTGAACGTACTTCGTGTGAATTTTATTGGGCATATGCT	46
KRS15CGC	TATGAAATTGGTAAAGTATTTAGAAATGAAGGTATAGATAATACACATAATCCTGAACGCACTTCGTGTGAATTTTATTGGGCATATGCT	44
KRS15CGA	TATGAAATTGGTAAAGTATTTAGAAATGAAGGTATAGATAATACACATAATCCTGAACGAACTTCGTGTGAATTTTATTGGGCATATGCT	0
KRS15CGG	TATGAAATTGGTAAAGTATTTAGAAATGAAGGTATAGATAATACACATAATCCTGAACGGACTTCGTGTGAATTTTATTGGGCATATGCT	4
KRS15AGT	TATGAAATTGGTAAAGTATTTAGAAATGAAGGTATAGATAATACACATAATCCTGAAAGTACTTCGTGTGAATTTTATTGGGCATATGCT	8
KRS15AGC	TATGAAATTGGTAAAGTATTTAGAAATGAAGGTATAGATAATACACATAATCCTGAAAGCACTTCGTGTGAATTTTATTGGGCATATGCT	113
KRS15AGA	TATGAAATTGGTAAAGTATTTAGAAATGAAGGTATAGATAATACACATAATCCTGAAAGAACTTCGTGTGAATTTTATTGGGCATATGCT	21
KRS15AGG	TATGAAATTGGTAAAGTATTTAGAAATGAAGGTATAGATAATACACATAATCCTGAAAGGACTTCGTGTGAATTTTATTGGGCATATGCT	2
KRS15GGT	TATGAAATTGGTAAAGTATTTAGAAATGAAGGTATAGATAATACACATAATCCTGAAGGTACTTCGTGTGAATTTTATTGGGCATATGCT	4
KRS15GGC	TATGAAATTGGTAAAGTATTTAGAAATGAAGGTATAGATAATACACATAATCCTGAAGGCACTTCGTGTGAATTTTATTGGGCATATGCT	7
KRS15GGA	TATGAAATTGGTAAAGTATTTAGAAATGAAGGTATAGATAATACACATAATCCTGAAGGAACTTCGTGTGAATTTTATTGGGCATATGCT	9
KRS15GGG	TATGAAATTGGTAAAGTATTTAGAAATGAAGGTATAGATAATACACATAATCCTGAAGGGACTTCGTGTGAATTTTATTGGGCATATGCT	4
KRS16TTT	TATGAAATTGGTAAAGTATTTAGAAATGAAGGTATAGATAATACACATAATCCTGAATTTTTTTCGTGTGAATTTTATTGGGCATATGCT	104
KRS16TTC	TATGAAATTGGTAAAGTATTTAGAAATGAAGGTATAGATAATACACATAATCCTGAATTTTTCTCGTGTGAATTTTATTGGGCATATGCT	17
KRS16TTA	TATGAAATTGGTAAAGTATTTAGAAATGAAGGTATAGATAATACACATAATCCTGAATTTTTATCGTGTGAATTTTATTGGGCATATGCT	1914
KRS16TTG	TATGAAATTGGTAAAGTATTTAGAAATGAAGGTATAGATAATACACATAATCCTGAATTTTTGTCGTGTGAATTTTATTGGGCATATGCT	32
KRS16CTT	TATGAAATTGGTAAAGTATTTAGAAATGAAGGTATAGATAATACACATAATCCTGAATTTCTTTCGTGTGAATTTTATTGGGCATATGCT	2
KRS16CTC	TATGAAATTGGTAAAGTATTTAGAAATGAAGGTATAGATAATACACATAATCCTGAATTTCTCTCGTGTGAATTTTATTGGGCATATGCT	4
KRS16CTA	TATGAAATTGGTAAAGTATTTAGAAATGAAGGTATAGATAATACACATAATCCTGAATTTCTATCGTGTGAATTTTATTGGGCATATGCT	165
KRS16CTG	TATGAAATTGGTAAAGTATTTAGAAATGAAGGTATAGATAATACACATAATCCTGAATTTCTGTCGTGTGAATTTTATTGGGCATATGCT	23
KRS16ATT	TATGAAATTGGTAAAGTATTTAGAAATGAAGGTATAGATAATACACATAATCCTGAATTTATTTCGTGTGAATTTTATTGGGCATATGCT	26
KRS16ATC	TATGAAATTGGTAAAGTATTTAGAAATGAAGGTATAGATAATACACATAATCCTGAATTTATCTCGTGTGAATTTTATTGGGCATATGCT	4368
KRS16ATA	TATGAAATTGGTAAAGTATTTAGAAATGAAGGTATAGATAATACACATAATCCTGAATTTATATCGTGTGAATTTTATTGGGCATATGCT	656
KRS16ATG	TATGAAATTGGTAAAGTATTTAGAAATGAAGGTATAGATAATACACATAATCCTGAATTTATGTCGTGTGAATTTTATTGGGCATATGCT	2423
KRS16GTT	TATGAAATTGGTAAAGTATTTAGAAATGAAGGTATAGATAATACACATAATCCTGAATTTGTTTCGTGTGAATTTTATTGGGCATATGCT	662
KRS16GTC	TATGAAATTGGTAAAGTATTTAGAAATGAAGGTATAGATAATACACATAATCCTGAATTTGTCTCGTGTGAATTTTATTGGGCATATGCT	8
KRS16GTA	TATGAAATTGGTAAAGTATTTAGAAATGAAGGTATAGATAATACACATAATCCTGAATTTGTATCGTGTGAATTTTATTGGGCATATGCT	12
KRS16GTG	TATGAAATTGGTAAAGTATTTAGAAATGAAGGTATAGATAATACACATAATCCTGAATTTGTGTCGTGTGAATTTTATTGGGCATATGCT	26
KRS16TCT	TATGAAATTGGTAAAGTATTTAGAAATGAAGGTATAGATAATACACATAATCCTGAATTTTCTTCGTGTGAATTTTATTGGGCATATGCT	455
KRS16TCC	TATGAAATTGGTAAAGTATTTAGAAATGAAGGTATAGATAATACACATAATCCTGAATTTTCCTCGTGTGAATTTTATTGGGCATATGCT	13
KRS16TCA	TATGAAATTGGTAAAGTATTTAGAAATGAAGGTATAGATAATACACATAATCCTGAATTTTCATCGTGTGAATTTTATTGGGCATATGCT	54
KRS16TCG	TATGAAATTGGTAAAGTATTTAGAAATGAAGGTATAGATAATACACATAATCCTGAATTTTCGTCGTGTGAATTTTATTGGGCATATGCT	1
KRS16CCT	TATGAAATTGGTAAAGTATTTAGAAATGAAGGTATAGATAATACACATAATCCTGAATTTCCTTCGTGTGAATTTTATTGGGCATATGCT	48
KRS16CCC	TATGAAATTGGTAAAGTATTTAGAAATGAAGGTATAGATAATACACATAATCCTGAATTTCCCTCGTGTGAATTTTATTGGGCATATGCT	8
KRS16CCA	TATGAAATTGGTAAAGTATTTAGAAATGAAGGTATAGATAATACACATAATCCTGAATTTCCATCGTGTGAATTTTATTGGGCATATGCT	1
KRS16CCG	TATGAAATTGGTAAAGTATTTAGAAATGAAGGTATAGATAATACACATAATCCTGAATTTCCGTCGTGTGAATTTTATTGGGCATATGCT	1
KRS16ACT	TATGAAATTGGTAAAGTATTTAGAAATGAAGGTATAGATAATACACATAATCCTGAATTTACTTCGTGTGAATTTTATTGGGCATATGCT	91560
KRS16ACC	TATGAAATTGGTAAAGTATTTAGAAATGAAGGTATAGATAATACACATAATCCTGAATTTACCTCGTGTGAATTTTATTGGGCATATGCT	3430
KRS16ACA	TATGAAATTGGTAAAGTATTTAGAAATGAAGGTATAGATAATACACATAATCCTGAATTTACATCGTGTGAATTTTATTGGGCATATGCT	332
KRS16ACG	TATGAAATTGGTAAAGTATTTAGAAATGAAGGTATAGATAATACACATAATCCTGAATTTACGTCGTGTGAATTTTATTGGGCATATGCT	74
KRS16GCT	TATGAAATTGGTAAAGTATTTAGAAATGAAGGTATAGATAATACACATAATCCTGAATTTGCTTCGTGTGAATTTTATTGGGCATATGCT	118
KRS16GCC	TATGAAATTGGTAAAGTATTTAGAAATGAAGGTATAGATAATACACATAATCCTGAATTTGCCTCGTGTGAATTTTATTGGGCATATGCT	413
KRS16GCA	TATGAAATTGGTAAAGTATTTAGAAATGAAGGTATAGATAATACACATAATCCTGAATTTGCATCGTGTGAATTTTATTGGGCATATGCT	5
KRS16GCG	TATGAAATTGGTAAAGTATTTAGAAATGAAGGTATAGATAATACACATAATCCTGAATTTGCGTCGTGTGAATTTTATTGGGCATATGCT	81
KRS16TAT	TATGAAATTGGTAAAGTATTTAGAAATGAAGGTATAGATAATACACATAATCCTGAATTTTATTCGTGTGAATTTTATTGGGCATATGCT	8940
KRS16TAC	TATGAAATTGGTAAAGTATTTAGAAATGAAGGTATAGATAATACACATAATCCTGAATTTTACTCGTGTGAATTTTATTGGGCATATGCT	56
KRS16TAA	TATGAAATTGGTAAAGTATTTAGAAATGAAGGTATAGATAATACACATAATCCTGAATTTTAATCGTGTGAATTTTATTGGGCATATGCT	136266
KRS16TAG	TATGAAATTGGTAAAGTATTTAGAAATGAAGGTATAGATAATACACATAATCCTGAATTTTAGTCGTGTGAATTTTATTGGGCATATGCT	225
KRS16CAT	TATGAAATTGGTAAAGTATTTAGAAATGAAGGTATAGATAATACACATAATCCTGAATTTCATTCGTGTGAATTTTATTGGGCATATGCT	26
KRS16CAC	TATGAAATTGGTAAAGTATTTAGAAATGAAGGTATAGATAATACACATAATCCTGAATTTCACTCGTGTGAATTTTATTGGGCATATGCT	59
KRS16CAA	TATGAAATTGGTAAAGTATTTAGAAATGAAGGTATAGATAATACACATAATCCTGAATTTCAATCGTGTGAATTTTATTGGGCATATGCT	883
KRS16CAG	TATGAAATTGGTAAAGTATTTAGAAATGAAGGTATAGATAATACACATAATCCTGAATTTCAGTCGTGTGAATTTTATTGGGCATATGCT	323
KRS16AAT	TATGAAATTGGTAAAGTATTTAGAAATGAAGGTATAGATAATACACATAATCCTGAATTTAATTCGTGTGAATTTTATTGGGCATATGCT	236
KRS16AAC	TATGAAATTGGTAAAGTATTTAGAAATGAAGGTATAGATAATACACATAATCCTGAATTTAACTCGTGTGAATTTTATTGGGCATATGCT	121
KRS16AAA	TATGAAATTGGTAAAGTATTTAGAAATGAAGGTATAGATAATACACATAATCCTGAATTTAAATCGTGTGAATTTTATTGGGCATATGCT	1046
KRS16AAG	TATGAAATTGGTAAAGTATTTAGAAATGAAGGTATAGATAATACACATAATCCTGAATTTAAGTCGTGTGAATTTTATTGGGCATATGCT	5
KRS16GAT	TATGAAATTGGTAAAGTATTTAGAAATGAAGGTATAGATAATACACATAATCCTGAATTTGATTCGTGTGAATTTTATTGGGCATATGCT	9
KRS16GAC	TATGAAATTGGTAAAGTATTTAGAAATGAAGGTATAGATAATACACATAATCCTGAATTTGACTCGTGTGAATTTTATTGGGCATATGCT	2
KRS16GAA	TATGAAATTGGTAAAGTATTTAGAAATGAAGGTATAGATAATACACATAATCCTGAATTTGAATCGTGTGAATTTTATTGGGCATATGCT	30
KRS16GAG	TATGAAATTGGTAAAGTATTTAGAAATGAAGGTATAGATAATACACATAATCCTGAATTTGAGTCGTGTGAATTTTATTGGGCATATGCT	6
KRS16TGT	TATGAAATTGGTAAAGTATTTAGAAATGAAGGTATAGATAATACACATAATCCTGAATTTTGTTCGTGTGAATTTTATTGGGCATATGCT	2416
KRS16TGC	TATGAAATTGGTAAAGTATTTAGAAATGAAGGTATAGATAATACACATAATCCTGAATTTTGCTCGTGTGAATTTTATTGGGCATATGCT	1636
KRS16TGA	TATGAAATTGGTAAAGTATTTAGAAATGAAGGTATAGATAATACACATAATCCTGAATTTTGATCGTGTGAATTTTATTGGGCATATGCT	195
KRS16TGG	TATGAAATTGGTAAAGTATTTAGAAATGAAGGTATAGATAATACACATAATCCTGAATTTTGGTCGTGTGAATTTTATTGGGCATATGCT	9
KRS16CGT	TATGAAATTGGTAAAGTATTTAGAAATGAAGGTATAGATAATACACATAATCCTGAATTTCGTTCGTGTGAATTTTATTGGGCATATGCT	5
KRS16CGC	TATGAAATTGGTAAAGTATTTAGAAATGAAGGTATAGATAATACACATAATCCTGAATTTCGCTCGTGTGAATTTTATTGGGCATATGCT	4
KRS16CGA	TATGAAATTGGTAAAGTATTTAGAAATGAAGGTATAGATAATACACATAATCCTGAATTTCGATCGTGTGAATTTTATTGGGCATATGCT	56
KRS16CGG	TATGAAATTGGTAAAGTATTTAGAAATGAAGGTATAGATAATACACATAATCCTGAATTTCGGTCGTGTGAATTTTATTGGGCATATGCT	3
KRS16AGT	TATGAAATTGGTAAAGTATTTAGAAATGAAGGTATAGATAATACACATAATCCTGAATTTAGTTCGTGTGAATTTTATTGGGCATATGCT	595
KRS16AGC	TATGAAATTGGTAAAGTATTTAGAAATGAAGGTATAGATAATACACATAATCCTGAATTTAGCTCGTGTGAATTTTATTGGGCATATGCT	105
KRS16AGA	TATGAAATTGGTAAAGTATTTAGAAATGAAGGTATAGATAATACACATAATCCTGAATTTAGATCGTGTGAATTTTATTGGGCATATGCT	4
KRS16AGG	TATGAAATTGGTAAAGTATTTAGAAATGAAGGTATAGATAATACACATAATCCTGAATTTAGGTCGTGTGAATTTTATTGGGCATATGCT	538
KRS16GGT	TATGAAATTGGTAAAGTATTTAGAAATGAAGGTATAGATAATACACATAATCCTGAATTTGGTTCGTGTGAATTTTATTGGGCATATGCT	3
KRS16GGC	TATGAAATTGGTAAAGTATTTAGAAATGAAGGTATAGATAATACACATAATCCTGAATTTGGCTCGTGTGAATTTTATTGGGCATATGCT	4
KRS16GGA	TATGAAATTGGTAAAGTATTTAGAAATGAAGGTATAGATAATACACATAATCCTGAATTTGGATCGTGTGAATTTTATTGGGCATATGCT	66
KRS16GGG	TATGAAATTGGTAAAGTATTTAGAAATGAAGGTATAGATAATACACATAATCCTGAATTTGGGTCGTGTGAATTTTATTGGGCATATGCT	1
KRS17TTT	TATGAAATTGGTAAAGTATTTAGAAATGAAGGTATAGATAATACACATAATCCTGAATTTACTTTTTGTGAATTTTATTGGGCATATGCT	214
KRS17TTC	TATGAAATTGGTAAAGTATTTAGAAATGAAGGTATAGATAATACACATAATCCTGAATTTACTTTCTGTGAATTTTATTGGGCATATGCT	114
KRS17TTA	TATGAAATTGGTAAAGTATTTAGAAATGAAGGTATAGATAATACACATAATCCTGAATTTACTTTATGTGAATTTTATTGGGCATATGCT	499418
KRS17TTG	TATGAAATTGGTAAAGTATTTAGAAATGAAGGTATAGATAATACACATAATCCTGAATTTACTTTGTGTGAATTTTATTGGGCATATGCT	1521
KRS17CTT	TATGAAATTGGTAAAGTATTTAGAAATGAAGGTATAGATAATACACATAATCCTGAATTTACTCTTTGTGAATTTTATTGGGCATATGCT	5221
KRS17CTC	TATGAAATTGGTAAAGTATTTAGAAATGAAGGTATAGATAATACACATAATCCTGAATTTACTCTCTGTGAATTTTATTGGGCATATGCT	38
KRS17CTA	TATGAAATTGGTAAAGTATTTAGAAATGAAGGTATAGATAATACACATAATCCTGAATTTACTCTATGTGAATTTTATTGGGCATATGCT	11498
KRS17CTG	TATGAAATTGGTAAAGTATTTAGAAATGAAGGTATAGATAATACACATAATCCTGAATTTACTCTGTGTGAATTTTATTGGGCATATGCT	730
KRS17ATT	TATGAAATTGGTAAAGTATTTAGAAATGAAGGTATAGATAATACACATAATCCTGAATTTACTATTTGTGAATTTTATTGGGCATATGCT	6746
KRS17ATC	TATGAAATTGGTAAAGTATTTAGAAATGAAGGTATAGATAATACACATAATCCTGAATTTACTATCTGTGAATTTTATTGGGCATATGCT	44464
KRS17ATA	TATGAAATTGGTAAAGTATTTAGAAATGAAGGTATAGATAATACACATAATCCTGAATTTACTATATGTGAATTTTATTGGGCATATGCT	587
KRS17ATG	TATGAAATTGGTAAAGTATTTAGAAATGAAGGTATAGATAATACACATAATCCTGAATTTACTATGTGTGAATTTTATTGGGCATATGCT	225904
KRS17GTT	TATGAAATTGGTAAAGTATTTAGAAATGAAGGTATAGATAATACACATAATCCTGAATTTACTGTTTGTGAATTTTATTGGGCATATGCT	94
KRS17GTC	TATGAAATTGGTAAAGTATTTAGAAATGAAGGTATAGATAATACACATAATCCTGAATTTACTGTCTGTGAATTTTATTGGGCATATGCT	62
KRS17GTA	TATGAAATTGGTAAAGTATTTAGAAATGAAGGTATAGATAATACACATAATCCTGAATTTACTGTATGTGAATTTTATTGGGCATATGCT	97
KRS17GTG	TATGAAATTGGTAAAGTATTTAGAAATGAAGGTATAGATAATACACATAATCCTGAATTTACTGTGTGTGAATTTTATTGGGCATATGCT	6479
KRS17TCT	TATGAAATTGGTAAAGTATTTAGAAATGAAGGTATAGATAATACACATAATCCTGAATTTACTTCTTGTGAATTTTATTGGGCATATGCT	11
KRS17TCC	TATGAAATTGGTAAAGTATTTAGAAATGAAGGTATAGATAATACACATAATCCTGAATTTACTTCCTGTGAATTTTATTGGGCATATGCT	82
KRS17TCA	TATGAAATTGGTAAAGTATTTAGAAATGAAGGTATAGATAATACACATAATCCTGAATTTACTTCATGTGAATTTTATTGGGCATATGCT	977
KRS17TCG	TATGAAATTGGTAAAGTATTTAGAAATGAAGGTATAGATAATACACATAATCCTGAATTTACTTCGTGTGAATTTTATTGGGCATATGCT	91560
KRS17CCT	TATGAAATTGGTAAAGTATTTAGAAATGAAGGTATAGATAATACACATAATCCTGAATTTACTCCTTGTGAATTTTATTGGGCATATGCT	29
KRS17CCC	TATGAAATTGGTAAAGTATTTAGAAATGAAGGTATAGATAATACACATAATCCTGAATTTACTCCCTGTGAATTTTATTGGGCATATGCT	112
KRS17CCA	TATGAAATTGGTAAAGTATTTAGAAATGAAGGTATAGATAATACACATAATCCTGAATTTACTCCATGTGAATTTTATTGGGCATATGCT	25
KRS17CCG	TATGAAATTGGTAAAGTATTTAGAAATGAAGGTATAGATAATACACATAATCCTGAATTTACTCCGTGTGAATTTTATTGGGCATATGCT	275
KRS17ACT	TATGAAATTGGTAAAGTATTTAGAAATGAAGGTATAGATAATACACATAATCCTGAATTTACTACTTGTGAATTTTATTGGGCATATGCT	78
KRS17ACC	TATGAAATTGGTAAAGTATTTAGAAATGAAGGTATAGATAATACACATAATCCTGAATTTACTACCTGTGAATTTTATTGGGCATATGCT	159
KRS17ACA	TATGAAATTGGTAAAGTATTTAGAAATGAAGGTATAGATAATACACATAATCCTGAATTTACTACATGTGAATTTTATTGGGCATATGCT	38
KRS17ACG	TATGAAATTGGTAAAGTATTTAGAAATGAAGGTATAGATAATACACATAATCCTGAATTTACTACGTGTGAATTTTATTGGGCATATGCT	624
KRS17GCT	TATGAAATTGGTAAAGTATTTAGAAATGAAGGTATAGATAATACACATAATCCTGAATTTACTGCTTGTGAATTTTATTGGGCATATGCT	16
KRS17GCC	TATGAAATTGGTAAAGTATTTAGAAATGAAGGTATAGATAATACACATAATCCTGAATTTACTGCCTGTGAATTTTATTGGGCATATGCT	5
KRS17GCA	TATGAAATTGGTAAAGTATTTAGAAATGAAGGTATAGATAATACACATAATCCTGAATTTACTGCATGTGAATTTTATTGGGCATATGCT	40
KRS17GCG	TATGAAATTGGTAAAGTATTTAGAAATGAAGGTATAGATAATACACATAATCCTGAATTTACTGCGTGTGAATTTTATTGGGCATATGCT	63
KRS17TAT	TATGAAATTGGTAAAGTATTTAGAAATGAAGGTATAGATAATACACATAATCCTGAATTTACTTATTGTGAATTTTATTGGGCATATGCT	31
KRS17TAC	TATGAAATTGGTAAAGTATTTAGAAATGAAGGTATAGATAATACACATAATCCTGAATTTACTTACTGTGAATTTTATTGGGCATATGCT	14
KRS17TAA	TATGAAATTGGTAAAGTATTTAGAAATGAAGGTATAGATAATACACATAATCCTGAATTTACTTAATGTGAATTTTATTGGGCATATGCT	3068
KRS17TAG	TATGAAATTGGTAAAGTATTTAGAAATGAAGGTATAGATAATACACATAATCCTGAATTTACTTAGTGTGAATTTTATTGGGCATATGCT	24
KRS17CAT	TATGAAATTGGTAAAGTATTTAGAAATGAAGGTATAGATAATACACATAATCCTGAATTTACTCATTGTGAATTTTATTGGGCATATGCT	9
KRS17CAC	TATGAAATTGGTAAAGTATTTAGAAATGAAGGTATAGATAATACACATAATCCTGAATTTACTCACTGTGAATTTTATTGGGCATATGCT	8
KRS17CAA	TATGAAATTGGTAAAGTATTTAGAAATGAAGGTATAGATAATACACATAATCCTGAATTTACTCAATGTGAATTTTATTGGGCATATGCT	40
KRS17CAG	TATGAAATTGGTAAAGTATTTAGAAATGAAGGTATAGATAATACACATAATCCTGAATTTACTCAGTGTGAATTTTATTGGGCATATGCT	5
KRS17AAT	TATGAAATTGGTAAAGTATTTAGAAATGAAGGTATAGATAATACACATAATCCTGAATTTACTAATTGTGAATTTTATTGGGCATATGCT	355
KRS17AAC	TATGAAATTGGTAAAGTATTTAGAAATGAAGGTATAGATAATACACATAATCCTGAATTTACTAACTGTGAATTTTATTGGGCATATGCT	378
KRS17AAA	TATGAAATTGGTAAAGTATTTAGAAATGAAGGTATAGATAATACACATAATCCTGAATTTACTAAATGTGAATTTTATTGGGCATATGCT	70
KRS17AAG	TATGAAATTGGTAAAGTATTTAGAAATGAAGGTATAGATAATACACATAATCCTGAATTTACTAAGTGTGAATTTTATTGGGCATATGCT	127
KRS17GAT	TATGAAATTGGTAAAGTATTTAGAAATGAAGGTATAGATAATACACATAATCCTGAATTTACTGATTGTGAATTTTATTGGGCATATGCT	9
KRS17GAC	TATGAAATTGGTAAAGTATTTAGAAATGAAGGTATAGATAATACACATAATCCTGAATTTACTGACTGTGAATTTTATTGGGCATATGCT	4
KRS17GAA	TATGAAATTGGTAAAGTATTTAGAAATGAAGGTATAGATAATACACATAATCCTGAATTTACTGAATGTGAATTTTATTGGGCATATGCT	23
KRS17GAG	TATGAAATTGGTAAAGTATTTAGAAATGAAGGTATAGATAATACACATAATCCTGAATTTACTGAGTGTGAATTTTATTGGGCATATGCT	7
KRS17TGT	TATGAAATTGGTAAAGTATTTAGAAATGAAGGTATAGATAATACACATAATCCTGAATTTACTTGTTGTGAATTTTATTGGGCATATGCT	1076
KRS17TGC	TATGAAATTGGTAAAGTATTTAGAAATGAAGGTATAGATAATACACATAATCCTGAATTTACTTGCTGTGAATTTTATTGGGCATATGCT	8
KRS17TGA	TATGAAATTGGTAAAGTATTTAGAAATGAAGGTATAGATAATACACATAATCCTGAATTTACTTGATGTGAATTTTATTGGGCATATGCT	48
KRS17TGG	TATGAAATTGGTAAAGTATTTAGAAATGAAGGTATAGATAATACACATAATCCTGAATTTACTTGGTGTGAATTTTATTGGGCATATGCT	111
KRS17CGT	TATGAAATTGGTAAAGTATTTAGAAATGAAGGTATAGATAATACACATAATCCTGAATTTACTCGTTGTGAATTTTATTGGGCATATGCT	8
KRS17CGC	TATGAAATTGGTAAAGTATTTAGAAATGAAGGTATAGATAATACACATAATCCTGAATTTACTCGCTGTGAATTTTATTGGGCATATGCT	4
KRS17CGA	TATGAAATTGGTAAAGTATTTAGAAATGAAGGTATAGATAATACACATAATCCTGAATTTACTCGATGTGAATTTTATTGGGCATATGCT	4
KRS17CGG	TATGAAATTGGTAAAGTATTTAGAAATGAAGGTATAGATAATACACATAATCCTGAATTTACTCGGTGTGAATTTTATTGGGCATATGCT	2
KRS17AGT	TATGAAATTGGTAAAGTATTTAGAAATGAAGGTATAGATAATACACATAATCCTGAATTTACTAGTTGTGAATTTTATTGGGCATATGCT	9
KRS17AGC	TATGAAATTGGTAAAGTATTTAGAAATGAAGGTATAGATAATACACATAATCCTGAATTTACTAGCTGTGAATTTTATTGGGCATATGCT	65
KRS17AGA	TATGAAATTGGTAAAGTATTTAGAAATGAAGGTATAGATAATACACATAATCCTGAATTTACTAGATGTGAATTTTATTGGGCATATGCT	6
KRS17AGG	TATGAAATTGGTAAAGTATTTAGAAATGAAGGTATAGATAATACACATAATCCTGAATTTACTAGGTGTGAATTTTATTGGGCATATGCT	23
KRS17GGT	TATGAAATTGGTAAAGTATTTAGAAATGAAGGTATAGATAATACACATAATCCTGAATTTACTGGTTGTGAATTTTATTGGGCATATGCT	5156
KRS17GGC	TATGAAATTGGTAAAGTATTTAGAAATGAAGGTATAGATAATACACATAATCCTGAATTTACTGGCTGTGAATTTTATTGGGCATATGCT	1107
KRS17GGA	TATGAAATTGGTAAAGTATTTAGAAATGAAGGTATAGATAATACACATAATCCTGAATTTACTGGATGTGAATTTTATTGGGCATATGCT	15
KRS17GGG	TATGAAATTGGTAAAGTATTTAGAAATGAAGGTATAGATAATACACATAATCCTGAATTTACTGGGTGTGAATTTTATTGGGCATATGCT	9
KRS18TTT	TATGAAATTGGTAAAGTATTTAGAAATGAAGGTATAGATAATACACATAATCCTGAATTTACTTCGTTTGAATTTTATTGGGCATATGCT	226
KRS18TTC	TATGAAATTGGTAAAGTATTTAGAAATGAAGGTATAGATAATACACATAATCCTGAATTTACTTCGTTCGAATTTTATTGGGCATATGCT	3
KRS18TTA	TATGAAATTGGTAAAGTATTTAGAAATGAAGGTATAGATAATACACATAATCCTGAATTTACTTCGTTAGAATTTTATTGGGCATATGCT	159
KRS18TTG	TATGAAATTGGTAAAGTATTTAGAAATGAAGGTATAGATAATACACATAATCCTGAATTTACTTCGTTGGAATTTTATTGGGCATATGCT	119
KRS18CTT	TATGAAATTGGTAAAGTATTTAGAAATGAAGGTATAGATAATACACATAATCCTGAATTTACTTCGCTTGAATTTTATTGGGCATATGCT	3
KRS18CTC	TATGAAATTGGTAAAGTATTTAGAAATGAAGGTATAGATAATACACATAATCCTGAATTTACTTCGCTCGAATTTTATTGGGCATATGCT	0
KRS18CTA	TATGAAATTGGTAAAGTATTTAGAAATGAAGGTATAGATAATACACATAATCCTGAATTTACTTCGCTAGAATTTTATTGGGCATATGCT	9
KRS18CTG	TATGAAATTGGTAAAGTATTTAGAAATGAAGGTATAGATAATACACATAATCCTGAATTTACTTCGCTGGAATTTTATTGGGCATATGCT	159
KRS18ATT	TATGAAATTGGTAAAGTATTTAGAAATGAAGGTATAGATAATACACATAATCCTGAATTTACTTCGATTGAATTTTATTGGGCATATGCT	2820
KRS18ATC	TATGAAATTGGTAAAGTATTTAGAAATGAAGGTATAGATAATACACATAATCCTGAATTTACTTCGATCGAATTTTATTGGGCATATGCT	12
KRS18ATA	TATGAAATTGGTAAAGTATTTAGAAATGAAGGTATAGATAATACACATAATCCTGAATTTACTTCGATAGAATTTTATTGGGCATATGCT	4961
KRS18ATG	TATGAAATTGGTAAAGTATTTAGAAATGAAGGTATAGATAATACACATAATCCTGAATTTACTTCGATGGAATTTTATTGGGCATATGCT	186
KRS18GTT	TATGAAATTGGTAAAGTATTTAGAAATGAAGGTATAGATAATACACATAATCCTGAATTTACTTCGGTTGAATTTTATTGGGCATATGCT	11
KRS18GTC	TATGAAATTGGTAAAGTATTTAGAAATGAAGGTATAGATAATACACATAATCCTGAATTTACTTCGGTCGAATTTTATTGGGCATATGCT	0
KRS18GTA	TATGAAATTGGTAAAGTATTTAGAAATGAAGGTATAGATAATACACATAATCCTGAATTTACTTCGGTAGAATTTTATTGGGCATATGCT	33
KRS18GTG	TATGAAATTGGTAAAGTATTTAGAAATGAAGGTATAGATAATACACATAATCCTGAATTTACTTCGGTGGAATTTTATTGGGCATATGCT	6
KRS18TCT	TATGAAATTGGTAAAGTATTTAGAAATGAAGGTATAGATAATACACATAATCCTGAATTTACTTCGTCTGAATTTTATTGGGCATATGCT	68
KRS18TCC	TATGAAATTGGTAAAGTATTTAGAAATGAAGGTATAGATAATACACATAATCCTGAATTTACTTCGTCCGAATTTTATTGGGCATATGCT	3
KRS18TCA	TATGAAATTGGTAAAGTATTTAGAAATGAAGGTATAGATAATACACATAATCCTGAATTTACTTCGTCAGAATTTTATTGGGCATATGCT	1
KRS18TCG	TATGAAATTGGTAAAGTATTTAGAAATGAAGGTATAGATAATACACATAATCCTGAATTTACTTCGTCGGAATTTTATTGGGCATATGCT	8
KRS18CCT	TATGAAATTGGTAAAGTATTTAGAAATGAAGGTATAGATAATACACATAATCCTGAATTTACTTCGCCTGAATTTTATTGGGCATATGCT	1
KRS18CCC	TATGAAATTGGTAAAGTATTTAGAAATGAAGGTATAGATAATACACATAATCCTGAATTTACTTCGCCCGAATTTTATTGGGCATATGCT	1
KRS18CCA	TATGAAATTGGTAAAGTATTTAGAAATGAAGGTATAGATAATACACATAATCCTGAATTTACTTCGCCAGAATTTTATTGGGCATATGCT	14
KRS18CCG	TATGAAATTGGTAAAGTATTTAGAAATGAAGGTATAGATAATACACATAATCCTGAATTTACTTCGCCGGAATTTTATTGGGCATATGCT	2
KRS18ACT	TATGAAATTGGTAAAGTATTTAGAAATGAAGGTATAGATAATACACATAATCCTGAATTTACTTCGACTGAATTTTATTGGGCATATGCT	2
KRS18ACC	TATGAAATTGGTAAAGTATTTAGAAATGAAGGTATAGATAATACACATAATCCTGAATTTACTTCGACCGAATTTTATTGGGCATATGCT	4
KRS18ACA	TATGAAATTGGTAAAGTATTTAGAAATGAAGGTATAGATAATACACATAATCCTGAATTTACTTCGACAGAATTTTATTGGGCATATGCT	11
KRS18ACG	TATGAAATTGGTAAAGTATTTAGAAATGAAGGTATAGATAATACACATAATCCTGAATTTACTTCGACGGAATTTTATTGGGCATATGCT	6
KRS18GCT	TATGAAATTGGTAAAGTATTTAGAAATGAAGGTATAGATAATACACATAATCCTGAATTTACTTCGGCTGAATTTTATTGGGCATATGCT	4
KRS18GCC	TATGAAATTGGTAAAGTATTTAGAAATGAAGGTATAGATAATACACATAATCCTGAATTTACTTCGGCCGAATTTTATTGGGCATATGCT	1
KRS18GCA	TATGAAATTGGTAAAGTATTTAGAAATGAAGGTATAGATAATACACATAATCCTGAATTTACTTCGGCAGAATTTTATTGGGCATATGCT	4
KRS18GCG	TATGAAATTGGTAAAGTATTTAGAAATGAAGGTATAGATAATACACATAATCCTGAATTTACTTCGGCGGAATTTTATTGGGCATATGCT	0
KRS18TAT	TATGAAATTGGTAAAGTATTTAGAAATGAAGGTATAGATAATACACATAATCCTGAATTTACTTCGTATGAATTTTATTGGGCATATGCT	63
KRS18TAC	TATGAAATTGGTAAAGTATTTAGAAATGAAGGTATAGATAATACACATAATCCTGAATTTACTTCGTACGAATTTTATTGGGCATATGCT	3
KRS18TAA	TATGAAATTGGTAAAGTATTTAGAAATGAAGGTATAGATAATACACATAATCCTGAATTTACTTCGTAAGAATTTTATTGGGCATATGCT	10
KRS18TAG	TATGAAATTGGTAAAGTATTTAGAAATGAAGGTATAGATAATACACATAATCCTGAATTTACTTCGTAGGAATTTTATTGGGCATATGCT	7
KRS18CAT	TATGAAATTGGTAAAGTATTTAGAAATGAAGGTATAGATAATACACATAATCCTGAATTTACTTCGCATGAATTTTATTGGGCATATGCT	10
KRS18CAC	TATGAAATTGGTAAAGTATTTAGAAATGAAGGTATAGATAATACACATAATCCTGAATTTACTTCGCACGAATTTTATTGGGCATATGCT	2
KRS18CAA	TATGAAATTGGTAAAGTATTTAGAAATGAAGGTATAGATAATACACATAATCCTGAATTTACTTCGCAAGAATTTTATTGGGCATATGCT	11
KRS18CAG	TATGAAATTGGTAAAGTATTTAGAAATGAAGGTATAGATAATACACATAATCCTGAATTTACTTCGCAGGAATTTTATTGGGCATATGCT	4
KRS18AAT	TATGAAATTGGTAAAGTATTTAGAAATGAAGGTATAGATAATACACATAATCCTGAATTTACTTCGAATGAATTTTATTGGGCATATGCT	18
KRS18AAC	TATGAAATTGGTAAAGTATTTAGAAATGAAGGTATAGATAATACACATAATCCTGAATTTACTTCGAACGAATTTTATTGGGCATATGCT	39
KRS18AAA	TATGAAATTGGTAAAGTATTTAGAAATGAAGGTATAGATAATACACATAATCCTGAATTTACTTCGAAAGAATTTTATTGGGCATATGCT	41
KRS18AAG	TATGAAATTGGTAAAGTATTTAGAAATGAAGGTATAGATAATACACATAATCCTGAATTTACTTCGAAGGAATTTTATTGGGCATATGCT	3
KRS18GAT	TATGAAATTGGTAAAGTATTTAGAAATGAAGGTATAGATAATACACATAATCCTGAATTTACTTCGGATGAATTTTATTGGGCATATGCT	5751
KRS18GAC	TATGAAATTGGTAAAGTATTTAGAAATGAAGGTATAGATAATACACATAATCCTGAATTTACTTCGGACGAATTTTATTGGGCATATGCT	14
KRS18GAA	TATGAAATTGGTAAAGTATTTAGAAATGAAGGTATAGATAATACACATAATCCTGAATTTACTTCGGAAGAATTTTATTGGGCATATGCT	5
KRS18GAG	TATGAAATTGGTAAAGTATTTAGAAATGAAGGTATAGATAATACACATAATCCTGAATTTACTTCGGAGGAATTTTATTGGGCATATGCT	1
KRS18TGT	TATGAAATTGGTAAAGTATTTAGAAATGAAGGTATAGATAATACACATAATCCTGAATTTACTTCGTGTGAATTTTATTGGGCATATGCT	91560
KRS18TGC	TATGAAATTGGTAAAGTATTTAGAAATGAAGGTATAGATAATACACATAATCCTGAATTTACTTCGTGCGAATTTTATTGGGCATATGCT	208
KRS18TGA	TATGAAATTGGTAAAGTATTTAGAAATGAAGGTATAGATAATACACATAATCCTGAATTTACTTCGTGAGAATTTTATTGGGCATATGCT	71
KRS18TGG	TATGAAATTGGTAAAGTATTTAGAAATGAAGGTATAGATAATACACATAATCCTGAATTTACTTCGTGGGAATTTTATTGGGCATATGCT	25
KRS18CGT	TATGAAATTGGTAAAGTATTTAGAAATGAAGGTATAGATAATACACATAATCCTGAATTTACTTCGCGTGAATTTTATTGGGCATATGCT	221
KRS18CGC	TATGAAATTGGTAAAGTATTTAGAAATGAAGGTATAGATAATACACATAATCCTGAATTTACTTCGCGCGAATTTTATTGGGCATATGCT	3
KRS18CGA	TATGAAATTGGTAAAGTATTTAGAAATGAAGGTATAGATAATACACATAATCCTGAATTTACTTCGCGAGAATTTTATTGGGCATATGCT	6515
KRS18CGG	TATGAAATTGGTAAAGTATTTAGAAATGAAGGTATAGATAATACACATAATCCTGAATTTACTTCGCGGGAATTTTATTGGGCATATGCT	7
KRS18AGT	TATGAAATTGGTAAAGTATTTAGAAATGAAGGTATAGATAATACACATAATCCTGAATTTACTTCGAGTGAATTTTATTGGGCATATGCT	64
KRS18AGC	TATGAAATTGGTAAAGTATTTAGAAATGAAGGTATAGATAATACACATAATCCTGAATTTACTTCGAGCGAATTTTATTGGGCATATGCT	1
KRS18AGA	TATGAAATTGGTAAAGTATTTAGAAATGAAGGTATAGATAATACACATAATCCTGAATTTACTTCGAGAGAATTTTATTGGGCATATGCT	1
KRS18AGG	TATGAAATTGGTAAAGTATTTAGAAATGAAGGTATAGATAATACACATAATCCTGAATTTACTTCGAGGGAATTTTATTGGGCATATGCT	4
KRS18GGT	TATGAAATTGGTAAAGTATTTAGAAATGAAGGTATAGATAATACACATAATCCTGAATTTACTTCGGGTGAATTTTATTGGGCATATGCT	31
KRS18GGC	TATGAAATTGGTAAAGTATTTAGAAATGAAGGTATAGATAATACACATAATCCTGAATTTACTTCGGGCGAATTTTATTGGGCATATGCT	2
KRS18GGA	TATGAAATTGGTAAAGTATTTAGAAATGAAGGTATAGATAATACACATAATCCTGAATTTACTTCGGGAGAATTTTATTGGGCATATGCT	14
KRS18GGG	TATGAAATTGGTAAAGTATTTAGAAATGAAGGTATAGATAATACACATAATCCTGAATTTACTTCGGGGGAATTTTATTGGGCATATGCT	2
KRS19TTT	TATGAAATTGGTAAAGTATTTAGAAATGAAGGTATAGATAATACACATAATCCTGAATTTACTTCGTGTTTTTTTTATTGGGCATATGCT	4
KRS19TTC	TATGAAATTGGTAAAGTATTTAGAAATGAAGGTATAGATAATACACATAATCCTGAATTTACTTCGTGTTTCTTTTATTGGGCATATGCT	3
KRS19TTA	TATGAAATTGGTAAAGTATTTAGAAATGAAGGTATAGATAATACACATAATCCTGAATTTACTTCGTGTTTATTTTATTGGGCATATGCT	19
KRS19TTG	TATGAAATTGGTAAAGTATTTAGAAATGAAGGTATAGATAATACACATAATCCTGAATTTACTTCGTGTTTGTTTTATTGGGCATATGCT	4
KRS19CTT	TATGAAATTGGTAAAGTATTTAGAAATGAAGGTATAGATAATACACATAATCCTGAATTTACTTCGTGTCTTTTTTATTGGGCATATGCT	4
KRS19CTC	TATGAAATTGGTAAAGTATTTAGAAATGAAGGTATAGATAATACACATAATCCTGAATTTACTTCGTGTCTCTTTTATTGGGCATATGCT	0
KRS19CTA	TATGAAATTGGTAAAGTATTTAGAAATGAAGGTATAGATAATACACATAATCCTGAATTTACTTCGTGTCTATTTTATTGGGCATATGCT	1
KRS19CTG	TATGAAATTGGTAAAGTATTTAGAAATGAAGGTATAGATAATACACATAATCCTGAATTTACTTCGTGTCTGTTTTATTGGGCATATGCT	4
KRS19ATT	TATGAAATTGGTAAAGTATTTAGAAATGAAGGTATAGATAATACACATAATCCTGAATTTACTTCGTGTATTTTTTATTGGGCATATGCT	5
KRS19ATC	TATGAAATTGGTAAAGTATTTAGAAATGAAGGTATAGATAATACACATAATCCTGAATTTACTTCGTGTATCTTTTATTGGGCATATGCT	3
KRS19ATA	TATGAAATTGGTAAAGTATTTAGAAATGAAGGTATAGATAATACACATAATCCTGAATTTACTTCGTGTATATTTTATTGGGCATATGCT	490
KRS19ATG	TATGAAATTGGTAAAGTATTTAGAAATGAAGGTATAGATAATACACATAATCCTGAATTTACTTCGTGTATGTTTTATTGGGCATATGCT	10
KRS19GTT	TATGAAATTGGTAAAGTATTTAGAAATGAAGGTATAGATAATACACATAATCCTGAATTTACTTCGTGTGTTTTTTATTGGGCATATGCT	3
KRS19GTC	TATGAAATTGGTAAAGTATTTAGAAATGAAGGTATAGATAATACACATAATCCTGAATTTACTTCGTGTGTCTTTTATTGGGCATATGCT	2
KRS19GTA	TATGAAATTGGTAAAGTATTTAGAAATGAAGGTATAGATAATACACATAATCCTGAATTTACTTCGTGTGTATTTTATTGGGCATATGCT	120
KRS19GTG	TATGAAATTGGTAAAGTATTTAGAAATGAAGGTATAGATAATACACATAATCCTGAATTTACTTCGTGTGTGTTTTATTGGGCATATGCT	1
KRS19TCT	TATGAAATTGGTAAAGTATTTAGAAATGAAGGTATAGATAATACACATAATCCTGAATTTACTTCGTGTTCTTTTTATTGGGCATATGCT	5
KRS19TCC	TATGAAATTGGTAAAGTATTTAGAAATGAAGGTATAGATAATACACATAATCCTGAATTTACTTCGTGTTCCTTTTATTGGGCATATGCT	0
KRS19TCA	TATGAAATTGGTAAAGTATTTAGAAATGAAGGTATAGATAATACACATAATCCTGAATTTACTTCGTGTTCATTTTATTGGGCATATGCT	5
KRS19TCG	TATGAAATTGGTAAAGTATTTAGAAATGAAGGTATAGATAATACACATAATCCTGAATTTACTTCGTGTTCGTTTTATTGGGCATATGCT	5
KRS19CCT	TATGAAATTGGTAAAGTATTTAGAAATGAAGGTATAGATAATACACATAATCCTGAATTTACTTCGTGTCCTTTTTATTGGGCATATGCT	3
KRS19CCC	TATGAAATTGGTAAAGTATTTAGAAATGAAGGTATAGATAATACACATAATCCTGAATTTACTTCGTGTCCCTTTTATTGGGCATATGCT	0
KRS19CCA	TATGAAATTGGTAAAGTATTTAGAAATGAAGGTATAGATAATACACATAATCCTGAATTTACTTCGTGTCCATTTTATTGGGCATATGCT	1
KRS19CCG	TATGAAATTGGTAAAGTATTTAGAAATGAAGGTATAGATAATACACATAATCCTGAATTTACTTCGTGTCCGTTTTATTGGGCATATGCT	0
KRS19ACT	TATGAAATTGGTAAAGTATTTAGAAATGAAGGTATAGATAATACACATAATCCTGAATTTACTTCGTGTACTTTTTATTGGGCATATGCT	3
KRS19ACC	TATGAAATTGGTAAAGTATTTAGAAATGAAGGTATAGATAATACACATAATCCTGAATTTACTTCGTGTACCTTTTATTGGGCATATGCT	1
KRS19ACA	TATGAAATTGGTAAAGTATTTAGAAATGAAGGTATAGATAATACACATAATCCTGAATTTACTTCGTGTACATTTTATTGGGCATATGCT	9
KRS19ACG	TATGAAATTGGTAAAGTATTTAGAAATGAAGGTATAGATAATACACATAATCCTGAATTTACTTCGTGTACGTTTTATTGGGCATATGCT	0
KRS19GCT	TATGAAATTGGTAAAGTATTTAGAAATGAAGGTATAGATAATACACATAATCCTGAATTTACTTCGTGTGCTTTTTATTGGGCATATGCT	2
KRS19GCC	TATGAAATTGGTAAAGTATTTAGAAATGAAGGTATAGATAATACACATAATCCTGAATTTACTTCGTGTGCCTTTTATTGGGCATATGCT	0
KRS19GCA	TATGAAATTGGTAAAGTATTTAGAAATGAAGGTATAGATAATACACATAATCCTGAATTTACTTCGTGTGCATTTTATTGGGCATATGCT	29
KRS19GCG	TATGAAATTGGTAAAGTATTTAGAAATGAAGGTATAGATAATACACATAATCCTGAATTTACTTCGTGTGCGTTTTATTGGGCATATGCT	4
KRS19TAT	TATGAAATTGGTAAAGTATTTAGAAATGAAGGTATAGATAATACACATAATCCTGAATTTACTTCGTGTTATTTTTATTGGGCATATGCT	4
KRS19TAC	TATGAAATTGGTAAAGTATTTAGAAATGAAGGTATAGATAATACACATAATCCTGAATTTACTTCGTGTTACTTTTATTGGGCATATGCT	2
KRS19TAA	TATGAAATTGGTAAAGTATTTAGAAATGAAGGTATAGATAATACACATAATCCTGAATTTACTTCGTGTTAATTTTATTGGGCATATGCT	36
KRS19TAG	TATGAAATTGGTAAAGTATTTAGAAATGAAGGTATAGATAATACACATAATCCTGAATTTACTTCGTGTTAGTTTTATTGGGCATATGCT	5
KRS19CAT	TATGAAATTGGTAAAGTATTTAGAAATGAAGGTATAGATAATACACATAATCCTGAATTTACTTCGTGTCATTTTTATTGGGCATATGCT	2
KRS19CAC	TATGAAATTGGTAAAGTATTTAGAAATGAAGGTATAGATAATACACATAATCCTGAATTTACTTCGTGTCACTTTTATTGGGCATATGCT	0
KRS19CAA	TATGAAATTGGTAAAGTATTTAGAAATGAAGGTATAGATAATACACATAATCCTGAATTTACTTCGTGTCAATTTTATTGGGCATATGCT	64
KRS19CAG	TATGAAATTGGTAAAGTATTTAGAAATGAAGGTATAGATAATACACATAATCCTGAATTTACTTCGTGTCAGTTTTATTGGGCATATGCT	3
KRS19AAT	TATGAAATTGGTAAAGTATTTAGAAATGAAGGTATAGATAATACACATAATCCTGAATTTACTTCGTGTAATTTTTATTGGGCATATGCT	16
KRS19AAC	TATGAAATTGGTAAAGTATTTAGAAATGAAGGTATAGATAATACACATAATCCTGAATTTACTTCGTGTAACTTTTATTGGGCATATGCT	6
KRS19AAA	TATGAAATTGGTAAAGTATTTAGAAATGAAGGTATAGATAATACACATAATCCTGAATTTACTTCGTGTAAATTTTATTGGGCATATGCT	84
KRS19AAG	TATGAAATTGGTAAAGTATTTAGAAATGAAGGTATAGATAATACACATAATCCTGAATTTACTTCGTGTAAGTTTTATTGGGCATATGCT	9
KRS19GAT	TATGAAATTGGTAAAGTATTTAGAAATGAAGGTATAGATAATACACATAATCCTGAATTTACTTCGTGTGATTTTTATTGGGCATATGCT	62
KRS19GAC	TATGAAATTGGTAAAGTATTTAGAAATGAAGGTATAGATAATACACATAATCCTGAATTTACTTCGTGTGACTTTTATTGGGCATATGCT	16
KRS19GAA	TATGAAATTGGTAAAGTATTTAGAAATGAAGGTATAGATAATACACATAATCCTGAATTTACTTCGTGTGAATTTTATTGGGCATATGCT	91560
KRS19GAG	TATGAAATTGGTAAAGTATTTAGAAATGAAGGTATAGATAATACACATAATCCTGAATTTACTTCGTGTGAGTTTTATTGGGCATATGCT	168
KRS19TGT	TATGAAATTGGTAAAGTATTTAGAAATGAAGGTATAGATAATACACATAATCCTGAATTTACTTCGTGTTGTTTTTATTGGGCATATGCT	9
KRS19TGC	TATGAAATTGGTAAAGTATTTAGAAATGAAGGTATAGATAATACACATAATCCTGAATTTACTTCGTGTTGCTTTTATTGGGCATATGCT	9
KRS19TGA	TATGAAATTGGTAAAGTATTTAGAAATGAAGGTATAGATAATACACATAATCCTGAATTTACTTCGTGTTGATTTTATTGGGCATATGCT	10
KRS19TGG	TATGAAATTGGTAAAGTATTTAGAAATGAAGGTATAGATAATACACATAATCCTGAATTTACTTCGTGTTGGTTTTATTGGGCATATGCT	9
KRS19CGT	TATGAAATTGGTAAAGTATTTAGAAATGAAGGTATAGATAATACACATAATCCTGAATTTACTTCGTGTCGTTTTTATTGGGCATATGCT	5
KRS19CGC	TATGAAATTGGTAAAGTATTTAGAAATGAAGGTATAGATAATACACATAATCCTGAATTTACTTCGTGTCGCTTTTATTGGGCATATGCT	2
KRS19CGA	TATGAAATTGGTAAAGTATTTAGAAATGAAGGTATAGATAATACACATAATCCTGAATTTACTTCGTGTCGATTTTATTGGGCATATGCT	5
KRS19CGG	TATGAAATTGGTAAAGTATTTAGAAATGAAGGTATAGATAATACACATAATCCTGAATTTACTTCGTGTCGGTTTTATTGGGCATATGCT	2
KRS19AGT	TATGAAATTGGTAAAGTATTTAGAAATGAAGGTATAGATAATACACATAATCCTGAATTTACTTCGTGTAGTTTTTATTGGGCATATGCT	12
KRS19AGC	TATGAAATTGGTAAAGTATTTAGAAATGAAGGTATAGATAATACACATAATCCTGAATTTACTTCGTGTAGCTTTTATTGGGCATATGCT	3
KRS19AGA	TATGAAATTGGTAAAGTATTTAGAAATGAAGGTATAGATAATACACATAATCCTGAATTTACTTCGTGTAGATTTTATTGGGCATATGCT	5
KRS19AGG	TATGAAATTGGTAAAGTATTTAGAAATGAAGGTATAGATAATACACATAATCCTGAATTTACTTCGTGTAGGTTTTATTGGGCATATGCT	1
KRS19GGT	TATGAAATTGGTAAAGTATTTAGAAATGAAGGTATAGATAATACACATAATCCTGAATTTACTTCGTGTGGTTTTTATTGGGCATATGCT	4
KRS19GGC	TATGAAATTGGTAAAGTATTTAGAAATGAAGGTATAGATAATACACATAATCCTGAATTTACTTCGTGTGGCTTTTATTGGGCATATGCT	7
KRS19GGA	TATGAAATTGGTAAAGTATTTAGAAATGAAGGTATAGATAATACACATAATCCTGAATTTACTTCGTGTGGATTTTATTGGGCATATGCT	259
KRS19GGG	TATGAAATTGGTAAAGTATTTAGAAATGAAGGTATAGATAATACACATAATCCTGAATTTACTTCGTGTGGGTTTTATTGGGCATATGCT	2
KRS20TTT	TATGAAATTGGTAAAGTATTTAGAAATGAAGGTATAGATAATACACATAATCCTGAATTTACTTCGTGTGAATTTTATTGGGCATATGCT	91560
KRS20TTC	TATGAAATTGGTAAAGTATTTAGAAATGAAGGTATAGATAATACACATAATCCTGAATTTACTTCGTGTGAATTCTATTGGGCATATGCT	149
KRS20TTA	TATGAAATTGGTAAAGTATTTAGAAATGAAGGTATAGATAATACACATAATCCTGAATTTACTTCGTGTGAATTATATTGGGCATATGCT	58
KRS20TTG	TATGAAATTGGTAAAGTATTTAGAAATGAAGGTATAGATAATACACATAATCCTGAATTTACTTCGTGTGAATTGTATTGGGCATATGCT	19
KRS20CTT	TATGAAATTGGTAAAGTATTTAGAAATGAAGGTATAGATAATACACATAATCCTGAATTTACTTCGTGTGAACTTTATTGGGCATATGCT	156
KRS20CTC	TATGAAATTGGTAAAGTATTTAGAAATGAAGGTATAGATAATACACATAATCCTGAATTTACTTCGTGTGAACTCTATTGGGCATATGCT	5
KRS20CTA	TATGAAATTGGTAAAGTATTTAGAAATGAAGGTATAGATAATACACATAATCCTGAATTTACTTCGTGTGAACTATATTGGGCATATGCT	28
KRS20CTG	TATGAAATTGGTAAAGTATTTAGAAATGAAGGTATAGATAATACACATAATCCTGAATTTACTTCGTGTGAACTGTATTGGGCATATGCT	16
KRS20ATT	TATGAAATTGGTAAAGTATTTAGAAATGAAGGTATAGATAATACACATAATCCTGAATTTACTTCGTGTGAAATTTATTGGGCATATGCT	3299
KRS20ATC	TATGAAATTGGTAAAGTATTTAGAAATGAAGGTATAGATAATACACATAATCCTGAATTTACTTCGTGTGAAATCTATTGGGCATATGCT	13
KRS20ATA	TATGAAATTGGTAAAGTATTTAGAAATGAAGGTATAGATAATACACATAATCCTGAATTTACTTCGTGTGAAATATATTGGGCATATGCT	9
KRS20ATG	TATGAAATTGGTAAAGTATTTAGAAATGAAGGTATAGATAATACACATAATCCTGAATTTACTTCGTGTGAAATGTATTGGGCATATGCT	7
KRS20GTT	TATGAAATTGGTAAAGTATTTAGAAATGAAGGTATAGATAATACACATAATCCTGAATTTACTTCGTGTGAAGTTTATTGGGCATATGCT	9
KRS20GTC	TATGAAATTGGTAAAGTATTTAGAAATGAAGGTATAGATAATACACATAATCCTGAATTTACTTCGTGTGAAGTCTATTGGGCATATGCT	5
KRS20GTA	TATGAAATTGGTAAAGTATTTAGAAATGAAGGTATAGATAATACACATAATCCTGAATTTACTTCGTGTGAAGTATATTGGGCATATGCT	3
KRS20GTG	TATGAAATTGGTAAAGTATTTAGAAATGAAGGTATAGATAATACACATAATCCTGAATTTACTTCGTGTGAAGTGTATTGGGCATATGCT	198
KRS20TCT	TATGAAATTGGTAAAGTATTTAGAAATGAAGGTATAGATAATACACATAATCCTGAATTTACTTCGTGTGAATCTTATTGGGCATATGCT	226
KRS20TCC	TATGAAATTGGTAAAGTATTTAGAAATGAAGGTATAGATAATACACATAATCCTGAATTTACTTCGTGTGAATCCTATTGGGCATATGCT	33
KRS20TCA	TATGAAATTGGTAAAGTATTTAGAAATGAAGGTATAGATAATACACATAATCCTGAATTTACTTCGTGTGAATCATATTGGGCATATGCT	3
KRS20TCG	TATGAAATTGGTAAAGTATTTAGAAATGAAGGTATAGATAATACACATAATCCTGAATTTACTTCGTGTGAATCGTATTGGGCATATGCT	9
KRS20CCT	TATGAAATTGGTAAAGTATTTAGAAATGAAGGTATAGATAATACACATAATCCTGAATTTACTTCGTGTGAACCTTATTGGGCATATGCT	3
KRS20CCC	TATGAAATTGGTAAAGTATTTAGAAATGAAGGTATAGATAATACACATAATCCTGAATTTACTTCGTGTGAACCCTATTGGGCATATGCT	6
KRS20CCA	TATGAAATTGGTAAAGTATTTAGAAATGAAGGTATAGATAATACACATAATCCTGAATTTACTTCGTGTGAACCATATTGGGCATATGCT	3
KRS20CCG	TATGAAATTGGTAAAGTATTTAGAAATGAAGGTATAGATAATACACATAATCCTGAATTTACTTCGTGTGAACCGTATTGGGCATATGCT	2
KRS20ACT	TATGAAATTGGTAAAGTATTTAGAAATGAAGGTATAGATAATACACATAATCCTGAATTTACTTCGTGTGAAACTTATTGGGCATATGCT	13
KRS20ACC	TATGAAATTGGTAAAGTATTTAGAAATGAAGGTATAGATAATACACATAATCCTGAATTTACTTCGTGTGAAACCTATTGGGCATATGCT	4
KRS20ACA	TATGAAATTGGTAAAGTATTTAGAAATGAAGGTATAGATAATACACATAATCCTGAATTTACTTCGTGTGAAACATATTGGGCATATGCT	519
KRS20ACG	TATGAAATTGGTAAAGTATTTAGAAATGAAGGTATAGATAATACACATAATCCTGAATTTACTTCGTGTGAAACGTATTGGGCATATGCT	9
KRS20GCT	TATGAAATTGGTAAAGTATTTAGAAATGAAGGTATAGATAATACACATAATCCTGAATTTACTTCGTGTGAAGCTTATTGGGCATATGCT	1
KRS20GCC	TATGAAATTGGTAAAGTATTTAGAAATGAAGGTATAGATAATACACATAATCCTGAATTTACTTCGTGTGAAGCCTATTGGGCATATGCT	2
KRS20GCA	TATGAAATTGGTAAAGTATTTAGAAATGAAGGTATAGATAATACACATAATCCTGAATTTACTTCGTGTGAAGCATATTGGGCATATGCT	12
KRS20GCG	TATGAAATTGGTAAAGTATTTAGAAATGAAGGTATAGATAATACACATAATCCTGAATTTACTTCGTGTGAAGCGTATTGGGCATATGCT	1
KRS20TAT	TATGAAATTGGTAAAGTATTTAGAAATGAAGGTATAGATAATACACATAATCCTGAATTTACTTCGTGTGAATATTATTGGGCATATGCT	43
KRS20TAC	TATGAAATTGGTAAAGTATTTAGAAATGAAGGTATAGATAATACACATAATCCTGAATTTACTTCGTGTGAATACTATTGGGCATATGCT	14
KRS20TAA	TATGAAATTGGTAAAGTATTTAGAAATGAAGGTATAGATAATACACATAATCCTGAATTTACTTCGTGTGAATAATATTGGGCATATGCT	440
KRS20TAG	TATGAAATTGGTAAAGTATTTAGAAATGAAGGTATAGATAATACACATAATCCTGAATTTACTTCGTGTGAATAGTATTGGGCATATGCT	9
KRS20CAT	TATGAAATTGGTAAAGTATTTAGAAATGAAGGTATAGATAATACACATAATCCTGAATTTACTTCGTGTGAACATTATTGGGCATATGCT	5
KRS20CAC	TATGAAATTGGTAAAGTATTTAGAAATGAAGGTATAGATAATACACATAATCCTGAATTTACTTCGTGTGAACACTATTGGGCATATGCT	5
KRS20CAA	TATGAAATTGGTAAAGTATTTAGAAATGAAGGTATAGATAATACACATAATCCTGAATTTACTTCGTGTGAACAATATTGGGCATATGCT	21
KRS20CAG	TATGAAATTGGTAAAGTATTTAGAAATGAAGGTATAGATAATACACATAATCCTGAATTTACTTCGTGTGAACAGTATTGGGCATATGCT	9
KRS20AAT	TATGAAATTGGTAAAGTATTTAGAAATGAAGGTATAGATAATACACATAATCCTGAATTTACTTCGTGTGAAAATTATTGGGCATATGCT	30
KRS20AAC	TATGAAATTGGTAAAGTATTTAGAAATGAAGGTATAGATAATACACATAATCCTGAATTTACTTCGTGTGAAAACTATTGGGCATATGCT	18
KRS20AAA	TATGAAATTGGTAAAGTATTTAGAAATGAAGGTATAGATAATACACATAATCCTGAATTTACTTCGTGTGAAAAATATTGGGCATATGCT	59
KRS20AAG	TATGAAATTGGTAAAGTATTTAGAAATGAAGGTATAGATAATACACATAATCCTGAATTTACTTCGTGTGAAAAGTATTGGGCATATGCT	24
KRS20GAT	TATGAAATTGGTAAAGTATTTAGAAATGAAGGTATAGATAATACACATAATCCTGAATTTACTTCGTGTGAAGATTATTGGGCATATGCT	2
KRS20GAC	TATGAAATTGGTAAAGTATTTAGAAATGAAGGTATAGATAATACACATAATCCTGAATTTACTTCGTGTGAAGACTATTGGGCATATGCT	6
KRS20GAA	TATGAAATTGGTAAAGTATTTAGAAATGAAGGTATAGATAATACACATAATCCTGAATTTACTTCGTGTGAAGAATATTGGGCATATGCT	13
KRS20GAG	TATGAAATTGGTAAAGTATTTAGAAATGAAGGTATAGATAATACACATAATCCTGAATTTACTTCGTGTGAAGAGTATTGGGCATATGCT	4
KRS20TGT	TATGAAATTGGTAAAGTATTTAGAAATGAAGGTATAGATAATACACATAATCCTGAATTTACTTCGTGTGAATGTTATTGGGCATATGCT	18
KRS20TGC	TATGAAATTGGTAAAGTATTTAGAAATGAAGGTATAGATAATACACATAATCCTGAATTTACTTCGTGTGAATGCTATTGGGCATATGCT	17
KRS20TGA	TATGAAATTGGTAAAGTATTTAGAAATGAAGGTATAGATAATACACATAATCCTGAATTTACTTCGTGTGAATGATATTGGGCATATGCT	6
KRS20TGG	TATGAAATTGGTAAAGTATTTAGAAATGAAGGTATAGATAATACACATAATCCTGAATTTACTTCGTGTGAATGGTATTGGGCATATGCT	7
KRS20CGT	TATGAAATTGGTAAAGTATTTAGAAATGAAGGTATAGATAATACACATAATCCTGAATTTACTTCGTGTGAACGTTATTGGGCATATGCT	1
KRS20CGC	TATGAAATTGGTAAAGTATTTAGAAATGAAGGTATAGATAATACACATAATCCTGAATTTACTTCGTGTGAACGCTATTGGGCATATGCT	2
KRS20CGA	TATGAAATTGGTAAAGTATTTAGAAATGAAGGTATAGATAATACACATAATCCTGAATTTACTTCGTGTGAACGATATTGGGCATATGCT	8
KRS20CGG	TATGAAATTGGTAAAGTATTTAGAAATGAAGGTATAGATAATACACATAATCCTGAATTTACTTCGTGTGAACGGTATTGGGCATATGCT	3
KRS20AGT	TATGAAATTGGTAAAGTATTTAGAAATGAAGGTATAGATAATACACATAATCCTGAATTTACTTCGTGTGAAAGTTATTGGGCATATGCT	17
KRS20AGC	TATGAAATTGGTAAAGTATTTAGAAATGAAGGTATAGATAATACACATAATCCTGAATTTACTTCGTGTGAAAGCTATTGGGCATATGCT	10
KRS20AGA	TATGAAATTGGTAAAGTATTTAGAAATGAAGGTATAGATAATACACATAATCCTGAATTTACTTCGTGTGAAAGATATTGGGCATATGCT	11
KRS20AGG	TATGAAATTGGTAAAGTATTTAGAAATGAAGGTATAGATAATACACATAATCCTGAATTTACTTCGTGTGAAAGGTATTGGGCATATGCT	6
KRS20GGT	TATGAAATTGGTAAAGTATTTAGAAATGAAGGTATAGATAATACACATAATCCTGAATTTACTTCGTGTGAAGGTTATTGGGCATATGCT	325
KRS20GGC	TATGAAATTGGTAAAGTATTTAGAAATGAAGGTATAGATAATACACATAATCCTGAATTTACTTCGTGTGAAGGCTATTGGGCATATGCT	949
KRS20GGA	TATGAAATTGGTAAAGTATTTAGAAATGAAGGTATAGATAATACACATAATCCTGAATTTACTTCGTGTGAAGGATATTGGGCATATGCT	1
KRS20GGG	TATGAAATTGGTAAAGTATTTAGAAATGAAGGTATAGATAATACACATAATCCTGAATTTACTTCGTGTGAAGGGTATTGGGCATATGCT	5
KRS_1TTT	TATGAAATTGGTTTTGTATTTAGAAATGAAGGTATAGATAATACACATAATCCTGAATTTACTTCGTGTGAATTTTATTGGGCATATGCT	0
KRS_1TTC	TATGAAATTGGTTTCGTATTTAGAAATGAAGGTATAGATAATACACATAATCCTGAATTTACTTCGTGTGAATTTTATTGGGCATATGCT	0
KRS_1TTA	TATGAAATTGGTTTAGTATTTAGAAATGAAGGTATAGATAATACACATAATCCTGAATTTACTTCGTGTGAATTTTATTGGGCATATGCT	0
KRS_1TTG	TATGAAATTGGTTTGGTATTTAGAAATGAAGGTATAGATAATACACATAATCCTGAATTTACTTCGTGTGAATTTTATTGGGCATATGCT	0
KRS_1CTT	TATGAAATTGGTCTTGTATTTAGAAATGAAGGTATAGATAATACACATAATCCTGAATTTACTTCGTGTGAATTTTATTGGGCATATGCT	0
KRS_1CTC	TATGAAATTGGTCTCGTATTTAGAAATGAAGGTATAGATAATACACATAATCCTGAATTTACTTCGTGTGAATTTTATTGGGCATATGCT	0
KRS_1CTA	TATGAAATTGGTCTAGTATTTAGAAATGAAGGTATAGATAATACACATAATCCTGAATTTACTTCGTGTGAATTTTATTGGGCATATGCT	0
KRS_1CTG	TATGAAATTGGTCTGGTATTTAGAAATGAAGGTATAGATAATACACATAATCCTGAATTTACTTCGTGTGAATTTTATTGGGCATATGCT	0
KRS_1ATT	TATGAAATTGGTATTGTATTTAGAAATGAAGGTATAGATAATACACATAATCCTGAATTTACTTCGTGTGAATTTTATTGGGCATATGCT	0
KRS_1ATC	TATGAAATTGGTATCGTATTTAGAAATGAAGGTATAGATAATACACATAATCCTGAATTTACTTCGTGTGAATTTTATTGGGCATATGCT	0
KRS_1ATA	TATGAAATTGGTATAGTATTTAGAAATGAAGGTATAGATAATACACATAATCCTGAATTTACTTCGTGTGAATTTTATTGGGCATATGCT	79
KRS_1ATG	TATGAAATTGGTATGGTATTTAGAAATGAAGGTATAGATAATACACATAATCCTGAATTTACTTCGTGTGAATTTTATTGGGCATATGCT	1
KRS_1GTT	TATGAAATTGGTGTTGTATTTAGAAATGAAGGTATAGATAATACACATAATCCTGAATTTACTTCGTGTGAATTTTATTGGGCATATGCT	0
KRS_1GTC	TATGAAATTGGTGTCGTATTTAGAAATGAAGGTATAGATAATACACATAATCCTGAATTTACTTCGTGTGAATTTTATTGGGCATATGCT	0
KRS_1GTA	TATGAAATTGGTGTAGTATTTAGAAATGAAGGTATAGATAATACACATAATCCTGAATTTACTTCGTGTGAATTTTATTGGGCATATGCT	0
KRS_1GTG	TATGAAATTGGTGTGGTATTTAGAAATGAAGGTATAGATAATACACATAATCCTGAATTTACTTCGTGTGAATTTTATTGGGCATATGCT	0
KRS_1TCT	TATGAAATTGGTTCTGTATTTAGAAATGAAGGTATAGATAATACACATAATCCTGAATTTACTTCGTGTGAATTTTATTGGGCATATGCT	0
KRS_1TCC	TATGAAATTGGTTCCGTATTTAGAAATGAAGGTATAGATAATACACATAATCCTGAATTTACTTCGTGTGAATTTTATTGGGCATATGCT	0
KRS_1TCA	TATGAAATTGGTTCAGTATTTAGAAATGAAGGTATAGATAATACACATAATCCTGAATTTACTTCGTGTGAATTTTATTGGGCATATGCT	0
KRS_1TCG	TATGAAATTGGTTCGGTATTTAGAAATGAAGGTATAGATAATACACATAATCCTGAATTTACTTCGTGTGAATTTTATTGGGCATATGCT	0
KRS_1CCT	TATGAAATTGGTCCTGTATTTAGAAATGAAGGTATAGATAATACACATAATCCTGAATTTACTTCGTGTGAATTTTATTGGGCATATGCT	0
KRS_1CCC	TATGAAATTGGTCCCGTATTTAGAAATGAAGGTATAGATAATACACATAATCCTGAATTTACTTCGTGTGAATTTTATTGGGCATATGCT	0
KRS_1CCA	TATGAAATTGGTCCAGTATTTAGAAATGAAGGTATAGATAATACACATAATCCTGAATTTACTTCGTGTGAATTTTATTGGGCATATGCT	0
KRS_1CCG	TATGAAATTGGTCCGGTATTTAGAAATGAAGGTATAGATAATACACATAATCCTGAATTTACTTCGTGTGAATTTTATTGGGCATATGCT	0
KRS_1ACT	TATGAAATTGGTACTGTATTTAGAAATGAAGGTATAGATAATACACATAATCCTGAATTTACTTCGTGTGAATTTTATTGGGCATATGCT	0
KRS_1ACC	TATGAAATTGGTACCGTATTTAGAAATGAAGGTATAGATAATACACATAATCCTGAATTTACTTCGTGTGAATTTTATTGGGCATATGCT	0
KRS_1ACA	TATGAAATTGGTACAGTATTTAGAAATGAAGGTATAGATAATACACATAATCCTGAATTTACTTCGTGTGAATTTTATTGGGCATATGCT	23
KRS_1ACG	TATGAAATTGGTACGGTATTTAGAAATGAAGGTATAGATAATACACATAATCCTGAATTTACTTCGTGTGAATTTTATTGGGCATATGCT	0
KRS_1GCT	TATGAAATTGGTGCTGTATTTAGAAATGAAGGTATAGATAATACACATAATCCTGAATTTACTTCGTGTGAATTTTATTGGGCATATGCT	0
KRS_1GCC	TATGAAATTGGTGCCGTATTTAGAAATGAAGGTATAGATAATACACATAATCCTGAATTTACTTCGTGTGAATTTTATTGGGCATATGCT	0
KRS_1GCA	TATGAAATTGGTGCAGTATTTAGAAATGAAGGTATAGATAATACACATAATCCTGAATTTACTTCGTGTGAATTTTATTGGGCATATGCT	0
KRS_1GCG	TATGAAATTGGTGCGGTATTTAGAAATGAAGGTATAGATAATACACATAATCCTGAATTTACTTCGTGTGAATTTTATTGGGCATATGCT	0
KRS_1TAT	TATGAAATTGGTTATGTATTTAGAAATGAAGGTATAGATAATACACATAATCCTGAATTTACTTCGTGTGAATTTTATTGGGCATATGCT	0
KRS_1TAC	TATGAAATTGGTTACGTATTTAGAAATGAAGGTATAGATAATACACATAATCCTGAATTTACTTCGTGTGAATTTTATTGGGCATATGCT	0
KRS_1TAA	TATGAAATTGGTTAAGTATTTAGAAATGAAGGTATAGATAATACACATAATCCTGAATTTACTTCGTGTGAATTTTATTGGGCATATGCT	69
KRS_1TAG	TATGAAATTGGTTAGGTATTTAGAAATGAAGGTATAGATAATACACATAATCCTGAATTTACTTCGTGTGAATTTTATTGGGCATATGCT	0
KRS_1CAT	TATGAAATTGGTCATGTATTTAGAAATGAAGGTATAGATAATACACATAATCCTGAATTTACTTCGTGTGAATTTTATTGGGCATATGCT	0
KRS_1CAC	TATGAAATTGGTCACGTATTTAGAAATGAAGGTATAGATAATACACATAATCCTGAATTTACTTCGTGTGAATTTTATTGGGCATATGCT	0
KRS_1CAA	TATGAAATTGGTCAAGTATTTAGAAATGAAGGTATAGATAATACACATAATCCTGAATTTACTTCGTGTGAATTTTATTGGGCATATGCT	19
KRS_1CAG	TATGAAATTGGTCAGGTATTTAGAAATGAAGGTATAGATAATACACATAATCCTGAATTTACTTCGTGTGAATTTTATTGGGCATATGCT	0
KRS_1AAT	TATGAAATTGGTAATGTATTTAGAAATGAAGGTATAGATAATACACATAATCCTGAATTTACTTCGTGTGAATTTTATTGGGCATATGCT	57
KRS_1AAC	TATGAAATTGGTAACGTATTTAGAAATGAAGGTATAGATAATACACATAATCCTGAATTTACTTCGTGTGAATTTTATTGGGCATATGCT	8
KRS_1AAA	TATGAAATTGGTAAAGTATTTAGAAATGAAGGTATAGATAATACACATAATCCTGAATTTACTTCGTGTGAATTTTATTGGGCATATGCT	91560
KRS_1AAG	TATGAAATTGGTAAGGTATTTAGAAATGAAGGTATAGATAATACACATAATCCTGAATTTACTTCGTGTGAATTTTATTGGGCATATGCT	354
KRS_1GAT	TATGAAATTGGTGATGTATTTAGAAATGAAGGTATAGATAATACACATAATCCTGAATTTACTTCGTGTGAATTTTATTGGGCATATGCT	0
KRS_1GAC	TATGAAATTGGTGACGTATTTAGAAATGAAGGTATAGATAATACACATAATCCTGAATTTACTTCGTGTGAATTTTATTGGGCATATGCT	0
KRS_1GAA	TATGAAATTGGTGAAGTATTTAGAAATGAAGGTATAGATAATACACATAATCCTGAATTTACTTCGTGTGAATTTTATTGGGCATATGCT	152
KRS_1GAG	TATGAAATTGGTGAGGTATTTAGAAATGAAGGTATAGATAATACACATAATCCTGAATTTACTTCGTGTGAATTTTATTGGGCATATGCT	1
KRS_1TGT	TATGAAATTGGTTGTGTATTTAGAAATGAAGGTATAGATAATACACATAATCCTGAATTTACTTCGTGTGAATTTTATTGGGCATATGCT	0
KRS_1TGC	TATGAAATTGGTTGCGTATTTAGAAATGAAGGTATAGATAATACACATAATCCTGAATTTACTTCGTGTGAATTTTATTGGGCATATGCT	0
KRS_1TGA	TATGAAATTGGTTGAGTATTTAGAAATGAAGGTATAGATAATACACATAATCCTGAATTTACTTCGTGTGAATTTTATTGGGCATATGCT	0
KRS_1TGG	TATGAAATTGGTTGGGTATTTAGAAATGAAGGTATAGATAATACACATAATCCTGAATTTACTTCGTGTGAATTTTATTGGGCATATGCT	0
KRS_1CGT	TATGAAATTGGTCGTGTATTTAGAAATGAAGGTATAGATAATACACATAATCCTGAATTTACTTCGTGTGAATTTTATTGGGCATATGCT	0
KRS_1CGC	TATGAAATTGGTCGCGTATTTAGAAATGAAGGTATAGATAATACACATAATCCTGAATTTACTTCGTGTGAATTTTATTGGGCATATGCT	0
KRS_1CGA	TATGAAATTGGTCGAGTATTTAGAAATGAAGGTATAGATAATACACATAATCCTGAATTTACTTCGTGTGAATTTTATTGGGCATATGCT	0
KRS_1CGG	TATGAAATTGGTCGGGTATTTAGAAATGAAGGTATAGATAATACACATAATCCTGAATTTACTTCGTGTGAATTTTATTGGGCATATGCT	0
KRS_1AGT	TATGAAATTGGTAGTGTATTTAGAAATGAAGGTATAGATAATACACATAATCCTGAATTTACTTCGTGTGAATTTTATTGGGCATATGCT	1
KRS_1AGC	TATGAAATTGGTAGCGTATTTAGAAATGAAGGTATAGATAATACACATAATCCTGAATTTACTTCGTGTGAATTTTATTGGGCATATGCT	0
KRS_1AGA	TATGAAATTGGTAGAGTATTTAGAAATGAAGGTATAGATAATACACATAATCCTGAATTTACTTCGTGTGAATTTTATTGGGCATATGCT	217
KRS_1AGG	TATGAAATTGGTAGGGTATTTAGAAATGAAGGTATAGATAATACACATAATCCTGAATTTACTTCGTGTGAATTTTATTGGGCATATGCT	0
KRS_1GGT	TATGAAATTGGTGGTGTATTTAGAAATGAAGGTATAGATAATACACATAATCCTGAATTTACTTCGTGTGAATTTTATTGGGCATATGCT	0
KRS_1GGC	TATGAAATTGGTGGCGTATTTAGAAATGAAGGTATAGATAATACACATAATCCTGAATTTACTTCGTGTGAATTTTATTGGGCATATGCT	0
KRS_1GGA	TATGAAATTGGTGGAGTATTTAGAAATGAAGGTATAGATAATACACATAATCCTGAATTTACTTCGTGTGAATTTTATTGGGCATATGCT	0
KRS_1GGG	TATGAAATTGGTGGGGTATTTAGAAATGAAGGTATAGATAATACACATAATCCTGAATTTACTTCGTGTGAATTTTATTGGGCATATGCT	0
KRS21TTT	TATGAAATTGGTAAAGTATTTAGAAATGAAGGTATAGATAATACACATAATCCTGAATTTACTTCGTGTGAATTTTTTTGGGCATATGCT	29
KRS21TTC	TATGAAATTGGTAAAGTATTTAGAAATGAAGGTATAGATAATACACATAATCCTGAATTTACTTCGTGTGAATTTTTCTGGGCATATGCT	0
KRS21TTA	TATGAAATTGGTAAAGTATTTAGAAATGAAGGTATAGATAATACACATAATCCTGAATTTACTTCGTGTGAATTTTTATGGGCATATGCT	0
KRS21TTG	TATGAAATTGGTAAAGTATTTAGAAATGAAGGTATAGATAATACACATAATCCTGAATTTACTTCGTGTGAATTTTTGTGGGCATATGCT	0
KRS21CTT	TATGAAATTGGTAAAGTATTTAGAAATGAAGGTATAGATAATACACATAATCCTGAATTTACTTCGTGTGAATTTCTTTGGGCATATGCT	0
KRS21CTC	TATGAAATTGGTAAAGTATTTAGAAATGAAGGTATAGATAATACACATAATCCTGAATTTACTTCGTGTGAATTTCTCTGGGCATATGCT	0
KRS21CTA	TATGAAATTGGTAAAGTATTTAGAAATGAAGGTATAGATAATACACATAATCCTGAATTTACTTCGTGTGAATTTCTATGGGCATATGCT	0
KRS21CTG	TATGAAATTGGTAAAGTATTTAGAAATGAAGGTATAGATAATACACATAATCCTGAATTTACTTCGTGTGAATTTCTGTGGGCATATGCT	0
KRS21ATT	TATGAAATTGGTAAAGTATTTAGAAATGAAGGTATAGATAATACACATAATCCTGAATTTACTTCGTGTGAATTTATTTGGGCATATGCT	2
KRS21ATC	TATGAAATTGGTAAAGTATTTAGAAATGAAGGTATAGATAATACACATAATCCTGAATTTACTTCGTGTGAATTTATCTGGGCATATGCT	0
KRS21ATA	TATGAAATTGGTAAAGTATTTAGAAATGAAGGTATAGATAATACACATAATCCTGAATTTACTTCGTGTGAATTTATATGGGCATATGCT	0
KRS21ATG	TATGAAATTGGTAAAGTATTTAGAAATGAAGGTATAGATAATACACATAATCCTGAATTTACTTCGTGTGAATTTATGTGGGCATATGCT	0
KRS21GTT	TATGAAATTGGTAAAGTATTTAGAAATGAAGGTATAGATAATACACATAATCCTGAATTTACTTCGTGTGAATTTGTTTGGGCATATGCT	0
KRS21GTC	TATGAAATTGGTAAAGTATTTAGAAATGAAGGTATAGATAATACACATAATCCTGAATTTACTTCGTGTGAATTTGTCTGGGCATATGCT	0
KRS21GTA	TATGAAATTGGTAAAGTATTTAGAAATGAAGGTATAGATAATACACATAATCCTGAATTTACTTCGTGTGAATTTGTATGGGCATATGCT	0
KRS21GTG	TATGAAATTGGTAAAGTATTTAGAAATGAAGGTATAGATAATACACATAATCCTGAATTTACTTCGTGTGAATTTGTGTGGGCATATGCT	0
KRS21TCT	TATGAAATTGGTAAAGTATTTAGAAATGAAGGTATAGATAATACACATAATCCTGAATTTACTTCGTGTGAATTTTCTTGGGCATATGCT	13
KRS21TCC	TATGAAATTGGTAAAGTATTTAGAAATGAAGGTATAGATAATACACATAATCCTGAATTTACTTCGTGTGAATTTTCCTGGGCATATGCT	0
KRS21TCA	TATGAAATTGGTAAAGTATTTAGAAATGAAGGTATAGATAATACACATAATCCTGAATTTACTTCGTGTGAATTTTCATGGGCATATGCT	0
KRS21TCG	TATGAAATTGGTAAAGTATTTAGAAATGAAGGTATAGATAATACACATAATCCTGAATTTACTTCGTGTGAATTTTCGTGGGCATATGCT	0
KRS21CCT	TATGAAATTGGTAAAGTATTTAGAAATGAAGGTATAGATAATACACATAATCCTGAATTTACTTCGTGTGAATTTCCTTGGGCATATGCT	0
KRS21CCC	TATGAAATTGGTAAAGTATTTAGAAATGAAGGTATAGATAATACACATAATCCTGAATTTACTTCGTGTGAATTTCCCTGGGCATATGCT	0
KRS21CCA	TATGAAATTGGTAAAGTATTTAGAAATGAAGGTATAGATAATACACATAATCCTGAATTTACTTCGTGTGAATTTCCATGGGCATATGCT	0
KRS21CCG	TATGAAATTGGTAAAGTATTTAGAAATGAAGGTATAGATAATACACATAATCCTGAATTTACTTCGTGTGAATTTCCGTGGGCATATGCT	0
KRS21ACT	TATGAAATTGGTAAAGTATTTAGAAATGAAGGTATAGATAATACACATAATCCTGAATTTACTTCGTGTGAATTTACTTGGGCATATGCT	0
KRS21ACC	TATGAAATTGGTAAAGTATTTAGAAATGAAGGTATAGATAATACACATAATCCTGAATTTACTTCGTGTGAATTTACCTGGGCATATGCT	0
KRS21ACA	TATGAAATTGGTAAAGTATTTAGAAATGAAGGTATAGATAATACACATAATCCTGAATTTACTTCGTGTGAATTTACATGGGCATATGCT	0
KRS21ACG	TATGAAATTGGTAAAGTATTTAGAAATGAAGGTATAGATAATACACATAATCCTGAATTTACTTCGTGTGAATTTACGTGGGCATATGCT	0
KRS21GCT	TATGAAATTGGTAAAGTATTTAGAAATGAAGGTATAGATAATACACATAATCCTGAATTTACTTCGTGTGAATTTGCTTGGGCATATGCT	0
KRS21GCC	TATGAAATTGGTAAAGTATTTAGAAATGAAGGTATAGATAATACACATAATCCTGAATTTACTTCGTGTGAATTTGCCTGGGCATATGCT	0
KRS21GCA	TATGAAATTGGTAAAGTATTTAGAAATGAAGGTATAGATAATACACATAATCCTGAATTTACTTCGTGTGAATTTGCATGGGCATATGCT	0
KRS21GCG	TATGAAATTGGTAAAGTATTTAGAAATGAAGGTATAGATAATACACATAATCCTGAATTTACTTCGTGTGAATTTGCGTGGGCATATGCT	0
KRS21TAT	TATGAAATTGGTAAAGTATTTAGAAATGAAGGTATAGATAATACACATAATCCTGAATTTACTTCGTGTGAATTTTATTGGGCATATGCT	91560
KRS21TAC	TATGAAATTGGTAAAGTATTTAGAAATGAAGGTATAGATAATACACATAATCCTGAATTTACTTCGTGTGAATTTTACTGGGCATATGCT	147
KRS21TAA	TATGAAATTGGTAAAGTATTTAGAAATGAAGGTATAGATAATACACATAATCCTGAATTTACTTCGTGTGAATTTTAATGGGCATATGCT	30
KRS21TAG	TATGAAATTGGTAAAGTATTTAGAAATGAAGGTATAGATAATACACATAATCCTGAATTTACTTCGTGTGAATTTTAGTGGGCATATGCT	15
KRS21CAT	TATGAAATTGGTAAAGTATTTAGAAATGAAGGTATAGATAATACACATAATCCTGAATTTACTTCGTGTGAATTTCATTGGGCATATGCT	79
KRS21CAC	TATGAAATTGGTAAAGTATTTAGAAATGAAGGTATAGATAATACACATAATCCTGAATTTACTTCGTGTGAATTTCACTGGGCATATGCT	0
KRS21CAA	TATGAAATTGGTAAAGTATTTAGAAATGAAGGTATAGATAATACACATAATCCTGAATTTACTTCGTGTGAATTTCAATGGGCATATGCT	0
KRS21CAG	TATGAAATTGGTAAAGTATTTAGAAATGAAGGTATAGATAATACACATAATCCTGAATTTACTTCGTGTGAATTTCAGTGGGCATATGCT	0
KRS21AAT	TATGAAATTGGTAAAGTATTTAGAAATGAAGGTATAGATAATACACATAATCCTGAATTTACTTCGTGTGAATTTAATTGGGCATATGCT	27
KRS21AAC	TATGAAATTGGTAAAGTATTTAGAAATGAAGGTATAGATAATACACATAATCCTGAATTTACTTCGTGTGAATTTAACTGGGCATATGCT	0
KRS21AAA	TATGAAATTGGTAAAGTATTTAGAAATGAAGGTATAGATAATACACATAATCCTGAATTTACTTCGTGTGAATTTAAATGGGCATATGCT	0
KRS21AAG	TATGAAATTGGTAAAGTATTTAGAAATGAAGGTATAGATAATACACATAATCCTGAATTTACTTCGTGTGAATTTAAGTGGGCATATGCT	0
KRS21GAT	TATGAAATTGGTAAAGTATTTAGAAATGAAGGTATAGATAATACACATAATCCTGAATTTACTTCGTGTGAATTTGATTGGGCATATGCT	4
KRS21GAC	TATGAAATTGGTAAAGTATTTAGAAATGAAGGTATAGATAATACACATAATCCTGAATTTACTTCGTGTGAATTTGACTGGGCATATGCT	0
KRS21GAA	TATGAAATTGGTAAAGTATTTAGAAATGAAGGTATAGATAATACACATAATCCTGAATTTACTTCGTGTGAATTTGAATGGGCATATGCT	0
KRS21GAG	TATGAAATTGGTAAAGTATTTAGAAATGAAGGTATAGATAATACACATAATCCTGAATTTACTTCGTGTGAATTTGAGTGGGCATATGCT	0
KRS21TGT	TATGAAATTGGTAAAGTATTTAGAAATGAAGGTATAGATAATACACATAATCCTGAATTTACTTCGTGTGAATTTTGTTGGGCATATGCT	102
KRS21TGC	TATGAAATTGGTAAAGTATTTAGAAATGAAGGTATAGATAATACACATAATCCTGAATTTACTTCGTGTGAATTTTGCTGGGCATATGCT	0
KRS21TGA	TATGAAATTGGTAAAGTATTTAGAAATGAAGGTATAGATAATACACATAATCCTGAATTTACTTCGTGTGAATTTTGATGGGCATATGCT	0
KRS21TGG	TATGAAATTGGTAAAGTATTTAGAAATGAAGGTATAGATAATACACATAATCCTGAATTTACTTCGTGTGAATTTTGGTGGGCATATGCT	0
KRS21CGT	TATGAAATTGGTAAAGTATTTAGAAATGAAGGTATAGATAATACACATAATCCTGAATTTACTTCGTGTGAATTTCGTTGGGCATATGCT	0
KRS21CGC	TATGAAATTGGTAAAGTATTTAGAAATGAAGGTATAGATAATACACATAATCCTGAATTTACTTCGTGTGAATTTCGCTGGGCATATGCT	0
KRS21CGA	TATGAAATTGGTAAAGTATTTAGAAATGAAGGTATAGATAATACACATAATCCTGAATTTACTTCGTGTGAATTTCGATGGGCATATGCT	0
KRS21CGG	TATGAAATTGGTAAAGTATTTAGAAATGAAGGTATAGATAATACACATAATCCTGAATTTACTTCGTGTGAATTTCGGTGGGCATATGCT	0
KRS21AGT	TATGAAATTGGTAAAGTATTTAGAAATGAAGGTATAGATAATACACATAATCCTGAATTTACTTCGTGTGAATTTAGTTGGGCATATGCT	0
KRS21AGC	TATGAAATTGGTAAAGTATTTAGAAATGAAGGTATAGATAATACACATAATCCTGAATTTACTTCGTGTGAATTTAGCTGGGCATATGCT	0
KRS21AGA	TATGAAATTGGTAAAGTATTTAGAAATGAAGGTATAGATAATACACATAATCCTGAATTTACTTCGTGTGAATTTAGATGGGCATATGCT	0
KRS21AGG	TATGAAATTGGTAAAGTATTTAGAAATGAAGGTATAGATAATACACATAATCCTGAATTTACTTCGTGTGAATTTAGGTGGGCATATGCT	0
KRS21GGT	TATGAAATTGGTAAAGTATTTAGAAATGAAGGTATAGATAATACACATAATCCTGAATTTACTTCGTGTGAATTTGGTTGGGCATATGCT	0
KRS21GGC	TATGAAATTGGTAAAGTATTTAGAAATGAAGGTATAGATAATACACATAATCCTGAATTTACTTCGTGTGAATTTGGCTGGGCATATGCT	0
KRS21GGA	TATGAAATTGGTAAAGTATTTAGAAATGAAGGTATAGATAATACACATAATCCTGAATTTACTTCGTGTGAATTTGGATGGGCATATGCT	0
KRS21GGG	TATGAAATTGGTAAAGTATTTAGAAATGAAGGTATAGATAATACACATAATCCTGAATTTACTTCGTGTGAATTTGGGTGGGCATATGCT	0
