Name	Sequence	Count
KRS1TTT	TATGAAATTGGTAAATTTTTTAGAAATGAAGGTATAGATAATACACATAATCCTGAATTTACTTCGTGTGAATTTTATTGGGCATATGCT	8945
KRS1TTC	TATGAAATTGGTAAATTCTTTAGAAATGAAGGTATAGATAATACACATAATCCTGAATTTACTTCGTGTGAATTTTATTGGGCATATGCT	2152
KRS1TTA	TATGAAATTGGTAAATTATTTAGAAATGAAGGTATAGATAATACACATAATCCTGAATTTACTTCGTGTGAATTTTATTGGGCATATGCT	1682
KRS1TTG	TATGAAATTGGTAAATTGTTTAGAAATGAAGGTATAGATAATACACATAATCCTGAATTTACTTCGTGTGAATTTTATTGGGCATATGCT	2826
KRS1CTT	TATGAAATTGGTAAACTTTTTAGAAATGAAGGTATAGATAATACACATAATCCTGAATTTACTTCGTGTGAATTTTATTGGGCATATGCT	2245
KRS1CTC	TATGAAATTGGTAAACTCTTTAGAAATGAAGGTATAGATAATACACATAATCCTGAATTTACTTCGTGTGAATTTTATTGGGCATATGCT	863
KRS1CTA	TATGAAATTGGTAAACTATTTAGAAATGAAGGTATAGATAATACACATAATCCTGAATTTACTTCGTGTGAATTTTATTGGGCATATGCT	850
KRS1CTG	TATGAAATTGGTAAACTGTTTAGAAATGAAGGTATAGATAATACACATAATCCTGAATTTACTTCGTGTGAATTTTATTGGGCATATGCT	1099
KRS1ATT	TATGAAATTGGTAAAATTTTTAGAAATGAAGGTATAGATAATACACATAATCCTGAATTTACTTCGTGTGAATTTTATTGGGCATATGCT	2254
KRS1ATC	TATGAAATTGGTAAAATCTTTAGAAATGAAGGTATAGATAATACACATAATCCTGAATTTACTTCGTGTGAATTTTATTGGGCATATGCT	1378
KRS1ATA	TATGAAATTGGTAAAATATTTAGAAATGAAGGTATAGATAATACACATAATCCTGAATTTACTTCGTGTGAATTTTATTGGGCATATGCT	753
KRS1ATG	TATGAAATTGGTAAAATGTTTAGAAATGAAGGTATAGATAATACACATAATCCTGAATTTACTTCGTGTGAATTTTATTGGGCATATGCT	974
KRS1GTT	TATGAAATTGGTAAAGTTTTTAGAAATGAAGGTATAGATAATACACATAATCCTGAATTTACTTCGTGTGAATTTTATTGGGCATATGCT	1986
KRS1GTC	TATGAAATTGGTAAAGTCTTTAGAAATGAAGGTATAGATAATACACATAATCCTGAATTTACTTCGTGTGAATTTTATTGGGCATATGCT	931
KRS1GTA	TATGAAATTGGTAAAGTATTTAGAAATGAAGGTATAGATAATACACATAATCCTGAATTTACTTCGTGTGAATTTTATTGGGCATATGCT	53004
KRS1GTG	TATGAAATTGGTAAAGTGTTTAGAAATGAAGGTATAGATAATACACATAATCCTGAATTTACTTCGTGTGAATTTTATTGGGCATATGCT	1153
KRS1TCT	TATGAAATTGGTAAATCTTTTAGAAATGAAGGTATAGATAATACACATAATCCTGAATTTACTTCGTGTGAATTTTATTGGGCATATGCT	2074
KRS1TCC	TATGAAATTGGTAAATCCTTTAGAAATGAAGGTATAGATAATACACATAATCCTGAATTTACTTCGTGTGAATTTTATTGGGCATATGCT	942
KRS1TCA	TATGAAATTGGTAAATCATTTAGAAATGAAGGTATAGATAATACACATAATCCTGAATTTACTTCGTGTGAATTTTATTGGGCATATGCT	1053
KRS1TCG	TATGAAATTGGTAAATCGTTTAGAAATGAAGGTATAGATAATACACATAATCCTGAATTTACTTCGTGTGAATTTTATTGGGCATATGCT	1558
KRS1CCT	TATGAAATTGGTAAACCTTTTAGAAATGAAGGTATAGATAATACACATAATCCTGAATTTACTTCGTGTGAATTTTATTGGGCATATGCT	1679
KRS1CCC	TATGAAATTGGTAAACCCTTTAGAAATGAAGGTATAGATAATACACATAATCCTGAATTTACTTCGTGTGAATTTTATTGGGCATATGCT	1491
KRS1CCA	TATGAAATTGGTAAACCATTTAGAAATGAAGGTATAGATAATACACATAATCCTGAATTTACTTCGTGTGAATTTTATTGGGCATATGCT	1016
KRS1CCG	TATGAAATTGGTAAACCGTTTAGAAATGAAGGTATAGATAATACACATAATCCTGAATTTACTTCGTGTGAATTTTATTGGGCATATGCT	1025
KRS1ACT	TATGAAATTGGTAAAACTTTTAGAAATGAAGGTATAGATAATACACATAATCCTGAATTTACTTCGTGTGAATTTTATTGGGCATATGCT	1276
KRS1ACC	TATGAAATTGGTAAAACCTTTAGAAATGAAGGTATAGATAATACACATAATCCTGAATTTACTTCGTGTGAATTTTATTGGGCATATGCT	2358
KRS1ACA	TATGAAATTGGTAAAACATTTAGAAATGAAGGTATAGATAATACACATAATCCTGAATTTACTTCGTGTGAATTTTATTGGGCATATGCT	931
KRS1ACG	TATGAAATTGGTAAAACGTTTAGAAATGAAGGTATAGATAATACACATAATCCTGAATTTACTTCGTGTGAATTTTATTGGGCATATGCT	1231
KRS1GCT	TATGAAATTGGTAAAGCTTTTAGAAATGAAGGTATAGATAATACACATAATCCTGAATTTACTTCGTGTGAATTTTATTGGGCATATGCT	1132
KRS1GCC	TATGAAATTGGTAAAGCCTTTAGAAATGAAGGTATAGATAATACACATAATCCTGAATTTACTTCGTGTGAATTTTATTGGGCATATGCT	1119
KRS1GCA	TATGAAATTGGTAAAGCATTTAGAAATGAAGGTATAGATAATACACATAATCCTGAATTTACTTCGTGTGAATTTTATTGGGCATATGCT	846
KRS1GCG	TATGAAATTGGTAAAGCGTTTAGAAATGAAGGTATAGATAATACACATAATCCTGAATTTACTTCGTGTGAATTTTATTGGGCATATGCT	852
KRS1TAT	TATGAAATTGGTAAATATTTTAGAAATGAAGGTATAGATAATACACATAATCCTGAATTTACTTCGTGTGAATTTTATTGGGCATATGCT	2313
KRS1TAC	TATGAAATTGGTAAATACTTTAGAAATGAAGGTATAGATAATACACATAATCCTGAATTTACTTCGTGTGAATTTTATTGGGCATATGCT	1110
KRS1TAA	TATGAAATTGGTAAATAATTTAGAAATGAAGGTATAGATAATACACATAATCCTGAATTTACTTCGTGTGAATTTTATTGGGCATATGCT	926
KRS1TAG	TATGAAATTGGTAAATAGTTTAGAAATGAAGGTATAGATAATACACATAATCCTGAATTTACTTCGTGTGAATTTTATTGGGCATATGCT	1569
KRS1CAT	TATGAAATTGGTAAACATTTTAGAAATGAAGGTATAGATAATACACATAATCCTGAATTTACTTCGTGTGAATTTTATTGGGCATATGCT	1647
KRS1CAC	TATGAAATTGGTAAACACTTTAGAAATGAAGGTATAGATAATACACATAATCCTGAATTTACTTCGTGTGAATTTTATTGGGCATATGCT	1876
KRS1CAA	TATGAAATTGGTAAACAATTTAGAAATGAAGGTATAGATAATACACATAATCCTGAATTTACTTCGTGTGAATTTTATTGGGCATATGCT	662
KRS1CAG	TATGAAATTGGTAAACAGTTTAGAAATGAAGGTATAGATAATACACATAATCCTGAATTTACTTCGTGTGAATTTTATTGGGCATATGCT	1124
KRS1AAT	TATGAAATTGGTAAAAATTTTAGAAATGAAGGTATAGATAATACACATAATCCTGAATTTACTTCGTGTGAATTTTATTGGGCATATGCT	1511
KRS1AAC	TATGAAATTGGTAAAAACTTTAGAAATGAAGGTATAGATAATACACATAATCCTGAATTTACTTCGTGTGAATTTTATTGGGCATATGCT	1150
KRS1AAA	TATGAAATTGGTAAAAAATTTAGAAATGAAGGTATAGATAATACACATAATCCTGAATTTACTTCGTGTGAATTTTATTGGGCATATGCT	687
KRS1AAG	TATGAAATTGGTAAAAAGTTTAGAAATGAAGGTATAGATAATACACATAATCCTGAATTTACTTCGTGTGAATTTTATTGGGCATATGCT	833
KRS1GAT	TATGAAATTGGTAAAGATTTTAGAAATGAAGGTATAGATAATACACATAATCCTGAATTTACTTCGTGTGAATTTTATTGGGCATATGCT	3749
KRS1GAC	TATGAAATTGGTAAAGACTTTAGAAATGAAGGTATAGATAATACACATAATCCTGAATTTACTTCGTGTGAATTTTATTGGGCATATGCT	1939
KRS1GAA	TATGAAATTGGTAAAGAATTTAGAAATGAAGGTATAGATAATACACATAATCCTGAATTTACTTCGTGTGAATTTTATTGGGCATATGCT	605
KRS1GAG	TATGAAATTGGTAAAGAGTTTAGAAATGAAGGTATAGATAATACACATAATCCTGAATTTACTTCGTGTGAATTTTATTGGGCATATGCT	591
KRS1TGT	TATGAAATTGGTAAATGTTTTAGAAATGAAGGTATAGATAATACACATAATCCTGAATTTACTTCGTGTGAATTTTATTGGGCATATGCT	1869
KRS1TGC	TATGAAATTGGTAAATGCTTTAGAAATGAAGGTATAGATAATACACATAATCCTGAATTTACTTCGTGTGAATTTTATTGGGCATATGCT	1434
KRS1TGA	TATGAAATTGGTAAATGATTTAGAAATGAAGGTATAGATAATACACATAATCCTGAATTTACTTCGTGTGAATTTTATTGGGCATATGCT	792
KRS1TGG	TATGAAATTGGTAAATGGTTTAGAAATGAAGGTATAGATAATACACATAATCCTGAATTTACTTCGTGTGAATTTTATTGGGCATATGCT	968
KRS1CGT	TATGAAATTGGTAAACGTTTTAGAAATGAAGGTATAGATAATACACATAATCCTGAATTTACTTCGTGTGAATTTTATTGGGCATATGCT	1281
KRS1CGC	TATGAAATTGGTAAACGCTTTAGAAATGAAGGTATAGATAATACACATAATCCTGAATTTACTTCGTGTGAATTTTATTGGGCATATGCT	3579
KRS1CGA	TATGAAATTGGTAAACGATTTAGAAATGAAGGTATAGATAATACACATAATCCTGAATTTACTTCGTGTGAATTTTATTGGGCATATGCT	442
KRS1CGG	TATGAAATTGGTAAACGGTTTAGAAATGAAGGTATAGATAATACACATAATCCTGAATTTACTTCGTGTGAATTTTATTGGGCATATGCT	676
KRS1AGT	TATGAAATTGGTAAAAGTTTTAGAAATGAAGGTATAGATAATACACATAATCCTGAATTTACTTCGTGTGAATTTTATTGGGCATATGCT	799
KRS1AGC	TATGAAATTGGTAAAAGCTTTAGAAATGAAGGTATAGATAATACACATAATCCTGAATTTACTTCGTGTGAATTTTATTGGGCATATGCT	1021
KRS1AGA	TATGAAATTGGTAAAAGATTTAGAAATGAAGGTATAGATAATACACATAATCCTGAATTTACTTCGTGTGAATTTTATTGGGCATATGCT	511
KRS1AGG	TATGAAATTGGTAAAAGGTTTAGAAATGAAGGTATAGATAATACACATAATCCTGAATTTACTTCGTGTGAATTTTATTGGGCATATGCT	1520
KRS1GGT	TATGAAATTGGTAAAGGTTTTAGAAATGAAGGTATAGATAATACACATAATCCTGAATTTACTTCGTGTGAATTTTATTGGGCATATGCT	1302
KRS1GGC	TATGAAATTGGTAAAGGCTTTAGAAATGAAGGTATAGATAATACACATAATCCTGAATTTACTTCGTGTGAATTTTATTGGGCATATGCT	689
KRS1GGA	TATGAAATTGGTAAAGGATTTAGAAATGAAGGTATAGATAATACACATAATCCTGAATTTACTTCGTGTGAATTTTATTGGGCATATGCT	339
KRS1GGG	TATGAAATTGGTAAAGGGTTTAGAAATGAAGGTATAGATAATACACATAATCCTGAATTTACTTCGTGTGAATTTTATTGGGCATATGCT	524
KRS2TTT	TATGAAATTGGTAAAGTATTTAGAAATGAAGGTATAGATAATACACATAATCCTGAATTTACTTCGTGTGAATTTTATTGGGCATATGCT	53004
KRS2TTC	TATGAAATTGGTAAAGTATTCAGAAATGAAGGTATAGATAATACACATAATCCTGAATTTACTTCGTGTGAATTTTATTGGGCATATGCT	1462
KRS2TTA	TATGAAATTGGTAAAGTATTAAGAAATGAAGGTATAGATAATACACATAATCCTGAATTTACTTCGTGTGAATTTTATTGGGCATATGCT	4033
KRS2TTG	TATGAAATTGGTAAAGTATTGAGAAATGAAGGTATAGATAATACACATAATCCTGAATTTACTTCGTGTGAATTTTATTGGGCATATGCT	1861
KRS2CTT	TATGAAATTGGTAAAGTACTTAGAAATGAAGGTATAGATAATACACATAATCCTGAATTTACTTCGTGTGAATTTTATTGGGCATATGCT	1494
KRS2CTC	TATGAAATTGGTAAAGTACTCAGAAATGAAGGTATAGATAATACACATAATCCTGAATTTACTTCGTGTGAATTTTATTGGGCATATGCT	455
KRS2CTA	TATGAAATTGGTAAAGTACTAAGAAATGAAGGTATAGATAATACACATAATCCTGAATTTACTTCGTGTGAATTTTATTGGGCATATGCT	1127
KRS2CTG	TATGAAATTGGTAAAGTACTGAGAAATGAAGGTATAGATAATACACATAATCCTGAATTTACTTCGTGTGAATTTTATTGGGCATATGCT	861
KRS2ATT	TATGAAATTGGTAAAGTAATTAGAAATGAAGGTATAGATAATACACATAATCCTGAATTTACTTCGTGTGAATTTTATTGGGCATATGCT	2647
KRS2ATC	TATGAAATTGGTAAAGTAATCAGAAATGAAGGTATAGATAATACACATAATCCTGAATTTACTTCGTGTGAATTTTATTGGGCATATGCT	862
KRS2ATA	TATGAAATTGGTAAAGTAATAAGAAATGAAGGTATAGATAATACACATAATCCTGAATTTACTTCGTGTGAATTTTATTGGGCATATGCT	1784
KRS2ATG	TATGAAATTGGTAAAGTAATGAGAAATGAAGGTATAGATAATACACATAATCCTGAATTTACTTCGTGTGAATTTTATTGGGCATATGCT	820
KRS2GTT	TATGAAATTGGTAAAGTAGTTAGAAATGAAGGTATAGATAATACACATAATCCTGAATTTACTTCGTGTGAATTTTATTGGGCATATGCT	1284
KRS2GTC	TATGAAATTGGTAAAGTAGTCAGAAATGAAGGTATAGATAATACACATAATCCTGAATTTACTTCGTGTGAATTTTATTGGGCATATGCT	323
KRS2GTA	TATGAAATTGGTAAAGTAGTAAGAAATGAAGGTATAGATAATACACATAATCCTGAATTTACTTCGTGTGAATTTTATTGGGCATATGCT	978
KRS2GTG	TATGAAATTGGTAAAGTAGTGAGAAATGAAGGTATAGATAATACACATAATCCTGAATTTACTTCGTGTGAATTTTATTGGGCATATGCT	516
KRS2TCT	TATGAAATTGGTAAAGTATCTAGAAATGAAGGTATAGATAATACACATAATCCTGAATTTACTTCGTGTGAATTTTATTGGGCATATGCT	3278
KRS2TCC	TATGAAATTGGTAAAGTATCCAGAAATGAAGGTATAGATAATACACATAATCCTGAATTTACTTCGTGTGAATTTTATTGGGCATATGCT	840
KRS2TCA	TATGAAATTGGTAAAGTATCAAGAAATGAAGGTATAGATAATACACATAATCCTGAATTTACTTCGTGTGAATTTTATTGGGCATATGCT	3893
KRS2TCG	TATGAAATTGGTAAAGTATCGAGAAATGAAGGTATAGATAATACACATAATCCTGAATTTACTTCGTGTGAATTTTATTGGGCATATGCT	259
KRS2CCT	TATGAAATTGGTAAAGTACCTAGAAATGAAGGTATAGATAATACACATAATCCTGAATTTACTTCGTGTGAATTTTATTGGGCATATGCT	1013
KRS2CCC	TATGAAATTGGTAAAGTACCCAGAAATGAAGGTATAGATAATACACATAATCCTGAATTTACTTCGTGTGAATTTTATTGGGCATATGCT	966
KRS2CCA	TATGAAATTGGTAAAGTACCAAGAAATGAAGGTATAGATAATACACATAATCCTGAATTTACTTCGTGTGAATTTTATTGGGCATATGCT	1166
KRS2CCG	TATGAAATTGGTAAAGTACCGAGAAATGAAGGTATAGATAATACACATAATCCTGAATTTACTTCGTGTGAATTTTATTGGGCATATGCT	398
KRS2ACT	TATGAAATTGGTAAAGTAACTAGAAATGAAGGTATAGATAATACACATAATCCTGAATTTACTTCGTGTGAATTTTATTGGGCATATGCT	1018
KRS2ACC	TATGAAATTGGTAAAGTAACCAGAAATGAAGGTATAGATAATACACATAATCCTGAATTTACTTCGTGTGAATTTTATTGGGCATATGCT	415
KRS2ACA	TATGAAATTGGTAAAGTAACAAGAAATGAAGGTATAGATAATACACATAATCCTGAATTTACTTCGTGTGAATTTTATTGGGCATATGCT	2671
KRS2ACG	TATGAAATTGGTAAAGTAACGAGAAATGAAGGTATAGATAATACACATAATCCTGAATTTACTTCGTGTGAATTTTATTGGGCATATGCT	374
KRS2GCT	TATGAAATTGGTAAAGTAGCTAGAAATGAAGGTATAGATAATACACATAATCCTGAATTTACTTCGTGTGAATTTTATTGGGCATATGCT	999
KRS2GCC	TATGAAATTGGTAAAGTAGCCAGAAATGAAGGTATAGATAATACACATAATCCTGAATTTACTTCGTGTGAATTTTATTGGGCATATGCT	292
KRS2GCA	TATGAAATTGGTAAAGTAGCAAGAAATGAAGGTATAGATAATACACATAATCCTGAATTTACTTCGTGTGAATTTTATTGGGCATATGCT	1482
KRS2GCG	TATGAAATTGGTAAAGTAGCGAGAAATGAAGGTATAGATAATACACATAATCCTGAATTTACTTCGTGTGAATTTTATTGGGCATATGCT	265
KRS2TAT	TATGAAATTGGTAAAGTATATAGAAATGAAGGTATAGATAATACACATAATCCTGAATTTACTTCGTGTGAATTTTATTGGGCATATGCT	1523
KRS2TAC	TATGAAATTGGTAAAGTATACAGAAATGAAGGTATAGATAATACACATAATCCTGAATTTACTTCGTGTGAATTTTATTGGGCATATGCT	531
KRS2TAA	TATGAAATTGGTAAAGTATAAAGAAATGAAGGTATAGATAATACACATAATCCTGAATTTACTTCGTGTGAATTTTATTGGGCATATGCT	2020
KRS2TAG	TATGAAATTGGTAAAGTATAGAGAAATGAAGGTATAGATAATACACATAATCCTGAATTTACTTCGTGTGAATTTTATTGGGCATATGCT	494
KRS2CAT	TATGAAATTGGTAAAGTACATAGAAATGAAGGTATAGATAATACACATAATCCTGAATTTACTTCGTGTGAATTTTATTGGGCATATGCT	1328
KRS2CAC	TATGAAATTGGTAAAGTACACAGAAATGAAGGTATAGATAATACACATAATCCTGAATTTACTTCGTGTGAATTTTATTGGGCATATGCT	613
KRS2CAA	TATGAAATTGGTAAAGTACAAAGAAATGAAGGTATAGATAATACACATAATCCTGAATTTACTTCGTGTGAATTTTATTGGGCATATGCT	4010
KRS2CAG	TATGAAATTGGTAAAGTACAGAGAAATGAAGGTATAGATAATACACATAATCCTGAATTTACTTCGTGTGAATTTTATTGGGCATATGCT	570
KRS2AAT	TATGAAATTGGTAAAGTAAATAGAAATGAAGGTATAGATAATACACATAATCCTGAATTTACTTCGTGTGAATTTTATTGGGCATATGCT	699
KRS2AAC	TATGAAATTGGTAAAGTAAACAGAAATGAAGGTATAGATAATACACATAATCCTGAATTTACTTCGTGTGAATTTTATTGGGCATATGCT	782
KRS2AAA	TATGAAATTGGTAAAGTAAAAAGAAATGAAGGTATAGATAATACACATAATCCTGAATTTACTTCGTGTGAATTTTATTGGGCATATGCT	2470
KRS2AAG	TATGAAATTGGTAAAGTAAAGAGAAATGAAGGTATAGATAATACACATAATCCTGAATTTACTTCGTGTGAATTTTATTGGGCATATGCT	344
KRS2GAT	TATGAAATTGGTAAAGTAGATAGAAATGAAGGTATAGATAATACACATAATCCTGAATTTACTTCGTGTGAATTTTATTGGGCATATGCT	647
KRS2GAC	TATGAAATTGGTAAAGTAGACAGAAATGAAGGTATAGATAATACACATAATCCTGAATTTACTTCGTGTGAATTTTATTGGGCATATGCT	379
KRS2GAA	TATGAAATTGGTAAAGTAGAAAGAAATGAAGGTATAGATAATACACATAATCCTGAATTTACTTCGTGTGAATTTTATTGGGCATATGCT	781
KRS2GAG	TATGAAATTGGTAAAGTAGAGAGAAATGAAGGTATAGATAATACACATAATCCTGAATTTACTTCGTGTGAATTTTATTGGGCATATGCT	292
KRS2TGT	TATGAAATTGGTAAAGTATGTAGAAATGAAGGTATAGATAATACACATAATCCTGAATTTACTTCGTGTGAATTTTATTGGGCATATGCT	1275
KRS2TGC	TATGAAATTGGTAAAGTATGCAGAAATGAAGGTATAGATAATACACATAATCCTGAATTTACTTCGTGTGAATTTTATTGGGCATATGCT	737
KRS2TGA	TATGAAATTGGTAAAGTATGAAGAAATGAAGGTATAGATAATACACATAATCCTGAATTTACTTCGTGTGAATTTTATTGGGCATATGCT	1378
KRS2TGG	TATGAAATTGGTAAAGTATGGAGAAATGAAGGTATAGATAATACACATAATCCTGAATTTACTTCGTGTGAATTTTATTGGGCATATGCT	526
KRS2CGT	TATGAAATTGGTAAAGTACGTAGAAATGAAGGTATAGATAATACACATAATCCTGAATTTACTTCGTGTGAATTTTATTGGGCATATGCT	597
KRS2CGC	TATGAAATTGGTAAAGTACGCAGAAATGAAGGTATAGATAATACACATAATCCTGAATTTACTTCGTGTGAATTTTATTGGGCATATGCT	493
KRS2CGA	TATGAAATTGGTAAAGTACGAAGAAATGAAGGTATAGATAATACACATAATCCTGAATTTACTTCGTGTGAATTTTATTGGGCATATGCT	1070
KRS2CGG	TATGAAATTGGTAAAGTACGGAGAAATGAAGGTATAGATAATACACATAATCCTGAATTTACTTCGTGTGAATTTTATTGGGCATATGCT	345
KRS2AGT	TATGAAATTGGTAAAGTAAGTAGAAATGAAGGTATAGATAATACACATAATCCTGAATTTACTTCGTGTGAATTTTATTGGGCATATGCT	707
KRS2AGC	TATGAAATTGGTAAAGTAAGCAGAAATGAAGGTATAGATAATACACATAATCCTGAATTTACTTCGTGTGAATTTTATTGGGCATATGCT	363
KRS2AGA	TATGAAATTGGTAAAGTAAGAAGAAATGAAGGTATAGATAATACACATAATCCTGAATTTACTTCGTGTGAATTTTATTGGGCATATGCT	936
KRS2AGG	TATGAAATTGGTAAAGTAAGGAGAAATGAAGGTATAGATAATACACATAATCCTGAATTTACTTCGTGTGAATTTTATTGGGCATATGCT	381
KRS2GGT	TATGAAATTGGTAAAGTAGGTAGAAATGAAGGTATAGATAATACACATAATCCTGAATTTACTTCGTGTGAATTTTATTGGGCATATGCT	528
KRS2GGC	TATGAAATTGGTAAAGTAGGCAGAAATGAAGGTATAGATAATACACATAATCCTGAATTTACTTCGTGTGAATTTTATTGGGCATATGCT	340
KRS2GGA	TATGAAATTGGTAAAGTAGGAAGAAATGAAGGTATAGATAATACACATAATCCTGAATTTACTTCGTGTGAATTTTATTGGGCATATGCT	784
KRS2GGG	TATGAAATTGGTAAAGTAGGGAGAAATGAAGGTATAGATAATACACATAATCCTGAATTTACTTCGTGTGAATTTTATTGGGCATATGCT	1489
KRS3TTT	TATGAAATTGGTAAAGTATTTTTTAATGAAGGTATAGATAATACACATAATCCTGAATTTACTTCGTGTGAATTTTATTGGGCATATGCT	3464
KRS3TTC	TATGAAATTGGTAAAGTATTTTTCAATGAAGGTATAGATAATACACATAATCCTGAATTTACTTCGTGTGAATTTTATTGGGCATATGCT	764
KRS3TTA	TATGAAATTGGTAAAGTATTTTTAAATGAAGGTATAGATAATACACATAATCCTGAATTTACTTCGTGTGAATTTTATTGGGCATATGCT	1021
KRS3TTG	TATGAAATTGGTAAAGTATTTTTGAATGAAGGTATAGATAATACACATAATCCTGAATTTACTTCGTGTGAATTTTATTGGGCATATGCT	1034
KRS3CTT	TATGAAATTGGTAAAGTATTTCTTAATGAAGGTATAGATAATACACATAATCCTGAATTTACTTCGTGTGAATTTTATTGGGCATATGCT	654
KRS3CTC	TATGAAATTGGTAAAGTATTTCTCAATGAAGGTATAGATAATACACATAATCCTGAATTTACTTCGTGTGAATTTTATTGGGCATATGCT	251
KRS3CTA	TATGAAATTGGTAAAGTATTTCTAAATGAAGGTATAGATAATACACATAATCCTGAATTTACTTCGTGTGAATTTTATTGGGCATATGCT	360
KRS3CTG	TATGAAATTGGTAAAGTATTTCTGAATGAAGGTATAGATAATACACATAATCCTGAATTTACTTCGTGTGAATTTTATTGGGCATATGCT	315
KRS3ATT	TATGAAATTGGTAAAGTATTTATTAATGAAGGTATAGATAATACACATAATCCTGAATTTACTTCGTGTGAATTTTATTGGGCATATGCT	794
KRS3ATC	TATGAAATTGGTAAAGTATTTATCAATGAAGGTATAGATAATACACATAATCCTGAATTTACTTCGTGTGAATTTTATTGGGCATATGCT	382
KRS3ATA	TATGAAATTGGTAAAGTATTTATAAATGAAGGTATAGATAATACACATAATCCTGAATTTACTTCGTGTGAATTTTATTGGGCATATGCT	502
KRS3ATG	TATGAAATTGGTAAAGTATTTATGAATGAAGGTATAGATAATACACATAATCCTGAATTTACTTCGTGTGAATTTTATTGGGCATATGCT	330
KRS3GTT	TATGAAATTGGTAAAGTATTTGTTAATGAAGGTATAGATAATACACATAATCCTGAATTTACTTCGTGTGAATTTTATTGGGCATATGCT	1070
KRS3GTC	TATGAAATTGGTAAAGTATTTGTCAATGAAGGTATAGATAATACACATAATCCTGAATTTACTTCGTGTGAATTTTATTGGGCATATGCT	286
KRS3GTA	TATGAAATTGGTAAAGTATTTGTAAATGAAGGTATAGATAATACACATAATCCTGAATTTACTTCGTGTGAATTTTATTGGGCATATGCT	413
KRS3GTG	TATGAAATTGGTAAAGTATTTGTGAATGAAGGTATAGATAATACACATAATCCTGAATTTACTTCGTGTGAATTTTATTGGGCATATGCT	394
KRS3TCT	TATGAAATTGGTAAAGTATTTTCTAATGAAGGTATAGATAATACACATAATCCTGAATTTACTTCGTGTGAATTTTATTGGGCATATGCT	780
KRS3TCC	TATGAAATTGGTAAAGTATTTTCCAATGAAGGTATAGATAATACACATAATCCTGAATTTACTTCGTGTGAATTTTATTGGGCATATGCT	320
KRS3TCA	TATGAAATTGGTAAAGTATTTTCAAATGAAGGTATAGATAATACACATAATCCTGAATTTACTTCGTGTGAATTTTATTGGGCATATGCT	499
KRS3TCG	TATGAAATTGGTAAAGTATTTTCGAATGAAGGTATAGATAATACACATAATCCTGAATTTACTTCGTGTGAATTTTATTGGGCATATGCT	224
KRS3CCT	TATGAAATTGGTAAAGTATTTCCTAATGAAGGTATAGATAATACACATAATCCTGAATTTACTTCGTGTGAATTTTATTGGGCATATGCT	257
KRS3CCC	TATGAAATTGGTAAAGTATTTCCCAATGAAGGTATAGATAATACACATAATCCTGAATTTACTTCGTGTGAATTTTATTGGGCATATGCT	155
KRS3CCA	TATGAAATTGGTAAAGTATTTCCAAATGAAGGTATAGATAATACACATAATCCTGAATTTACTTCGTGTGAATTTTATTGGGCATATGCT	338
KRS3CCG	TATGAAATTGGTAAAGTATTTCCGAATGAAGGTATAGATAATACACATAATCCTGAATTTACTTCGTGTGAATTTTATTGGGCATATGCT	186
KRS3ACT	TATGAAATTGGTAAAGTATTTACTAATGAAGGTATAGATAATACACATAATCCTGAATTTACTTCGTGTGAATTTTATTGGGCATATGCT	248
KRS3ACC	TATGAAATTGGTAAAGTATTTACCAATGAAGGTATAGATAATACACATAATCCTGAATTTACTTCGTGTGAATTTTATTGGGCATATGCT	201
KRS3ACA	TATGAAATTGGTAAAGTATTTACAAATGAAGGTATAGATAATACACATAATCCTGAATTTACTTCGTGTGAATTTTATTGGGCATATGCT	480
KRS3ACG	TATGAAATTGGTAAAGTATTTACGAATGAAGGTATAGATAATACACATAATCCTGAATTTACTTCGTGTGAATTTTATTGGGCATATGCT	185
KRS3GCT	TATGAAATTGGTAAAGTATTTGCTAATGAAGGTATAGATAATACACATAATCCTGAATTTACTTCGTGTGAATTTTATTGGGCATATGCT	313
KRS3GCC	TATGAAATTGGTAAAGTATTTGCCAATGAAGGTATAGATAATACACATAATCCTGAATTTACTTCGTGTGAATTTTATTGGGCATATGCT	199
KRS3GCA	TATGAAATTGGTAAAGTATTTGCAAATGAAGGTATAGATAATACACATAATCCTGAATTTACTTCGTGTGAATTTTATTGGGCATATGCT	450
KRS3GCG	TATGAAATTGGTAAAGTATTTGCGAATGAAGGTATAGATAATACACATAATCCTGAATTTACTTCGTGTGAATTTTATTGGGCATATGCT	323
KRS3TAT	TATGAAATTGGTAAAGTATTTTATAATGAAGGTATAGATAATACACATAATCCTGAATTTACTTCGTGTGAATTTTATTGGGCATATGCT	1392
KRS3TAC	TATGAAATTGGTAAAGTATTTTACAATGAAGGTATAGATAATACACATAATCCTGAATTTACTTCGTGTGAATTTTATTGGGCATATGCT	509
KRS3TAA	TATGAAATTGGTAAAGTATTTTAAAATGAAGGTATAGATAATACACATAATCCTGAATTTACTTCGTGTGAATTTTATTGGGCATATGCT	701
KRS3TAG	TATGAAATTGGTAAAGTATTTTAGAATGAAGGTATAGATAATACACATAATCCTGAATTTACTTCGTGTGAATTTTATTGGGCATATGCT	423
KRS3CAT	TATGAAATTGGTAAAGTATTTCATAATGAAGGTATAGATAATACACATAATCCTGAATTTACTTCGTGTGAATTTTATTGGGCATATGCT	367
KRS3CAC	TATGAAATTGGTAAAGTATTTCACAATGAAGGTATAGATAATACACATAATCCTGAATTTACTTCGTGTGAATTTTATTGGGCATATGCT	312
KRS3CAA	TATGAAATTGGTAAAGTATTTCAAAATGAAGGTATAGATAATACACATAATCCTGAATTTACTTCGTGTGAATTTTATTGGGCATATGCT	492
KRS3CAG	TATGAAATTGGTAAAGTATTTCAGAATGAAGGTATAGATAATACACATAATCCTGAATTTACTTCGTGTGAATTTTATTGGGCATATGCT	304
KRS3AAT	TATGAAATTGGTAAAGTATTTAATAATGAAGGTATAGATAATACACATAATCCTGAATTTACTTCGTGTGAATTTTATTGGGCATATGCT	589
KRS3AAC	TATGAAATTGGTAAAGTATTTAACAATGAAGGTATAGATAATACACATAATCCTGAATTTACTTCGTGTGAATTTTATTGGGCATATGCT	389
KRS3AAA	TATGAAATTGGTAAAGTATTTAAAAATGAAGGTATAGATAATACACATAATCCTGAATTTACTTCGTGTGAATTTTATTGGGCATATGCT	661
KRS3AAG	TATGAAATTGGTAAAGTATTTAAGAATGAAGGTATAGATAATACACATAATCCTGAATTTACTTCGTGTGAATTTTATTGGGCATATGCT	378
KRS3GAT	TATGAAATTGGTAAAGTATTTGATAATGAAGGTATAGATAATACACATAATCCTGAATTTACTTCGTGTGAATTTTATTGGGCATATGCT	1580
KRS3GAC	TATGAAATTGGTAAAGTATTTGACAATGAAGGTATAGATAATACACATAATCCTGAATTTACTTCGTGTGAATTTTATTGGGCATATGCT	343
KRS3GAA	TATGAAATTGGTAAAGTATTTGAAAATGAAGGTATAGATAATACACATAATCCTGAATTTACTTCGTGTGAATTTTATTGGGCATATGCT	405
KRS3GAG	TATGAAATTGGTAAAGTATTTGAGAATGAAGGTATAGATAATACACATAATCCTGAATTTACTTCGTGTGAATTTTATTGGGCATATGCT	249
KRS3TGT	TATGAAATTGGTAAAGTATTTTGTAATGAAGGTATAGATAATACACATAATCCTGAATTTACTTCGTGTGAATTTTATTGGGCATATGCT	1031
KRS3TGC	TATGAAATTGGTAAAGTATTTTGCAATGAAGGTATAGATAATACACATAATCCTGAATTTACTTCGTGTGAATTTTATTGGGCATATGCT	402
KRS3TGA	TATGAAATTGGTAAAGTATTTTGAAATGAAGGTATAGATAATACACATAATCCTGAATTTACTTCGTGTGAATTTTATTGGGCATATGCT	781
KRS3TGG	TATGAAATTGGTAAAGTATTTTGGAATGAAGGTATAGATAATACACATAATCCTGAATTTACTTCGTGTGAATTTTATTGGGCATATGCT	394
KRS3CGT	TATGAAATTGGTAAAGTATTTCGTAATGAAGGTATAGATAATACACATAATCCTGAATTTACTTCGTGTGAATTTTATTGGGCATATGCT	184
KRS3CGC	TATGAAATTGGTAAAGTATTTCGCAATGAAGGTATAGATAATACACATAATCCTGAATTTACTTCGTGTGAATTTTATTGGGCATATGCT	178
KRS3CGA	TATGAAATTGGTAAAGTATTTCGAAATGAAGGTATAGATAATACACATAATCCTGAATTTACTTCGTGTGAATTTTATTGGGCATATGCT	242
KRS3CGG	TATGAAATTGGTAAAGTATTTCGGAATGAAGGTATAGATAATACACATAATCCTGAATTTACTTCGTGTGAATTTTATTGGGCATATGCT	161
KRS3AGT	TATGAAATTGGTAAAGTATTTAGTAATGAAGGTATAGATAATACACATAATCCTGAATTTACTTCGTGTGAATTTTATTGGGCATATGCT	345
KRS3AGC	TATGAAATTGGTAAAGTATTTAGCAATGAAGGTATAGATAATACACATAATCCTGAATTTACTTCGTGTGAATTTTATTGGGCATATGCT	221
KRS3AGA	TATGAAATTGGTAAAGTATTTAGAAATGAAGGTATAGATAATACACATAATCCTGAATTTACTTCGTGTGAATTTTATTGGGCATATGCT	53004
KRS3AGG	TATGAAATTGGTAAAGTATTTAGGAATGAAGGTATAGATAATACACATAATCCTGAATTTACTTCGTGTGAATTTTATTGGGCATATGCT	267
KRS3GGT	TATGAAATTGGTAAAGTATTTGGTAATGAAGGTATAGATAATACACATAATCCTGAATTTACTTCGTGTGAATTTTATTGGGCATATGCT	216
KRS3GGC	TATGAAATTGGTAAAGTATTTGGCAATGAAGGTATAGATAATACACATAATCCTGAATTTACTTCGTGTGAATTTTATTGGGCATATGCT	195
KRS3GGA	TATGAAATTGGTAAAGTATTTGGAAATGAAGGTATAGATAATACACATAATCCTGAATTTACTTCGTGTGAATTTTATTGGGCATATGCT	313
KRS3GGG	TATGAAATTGGTAAAGTATTTGGGAATGAAGGTATAGATAATACACATAATCCTGAATTTACTTCGTGTGAATTTTATTGGGCATATGCT	142
KRS4TTT	TATGAAATTGGTAAAGTATTTAGATTTGAAGGTATAGATAATACACATAATCCTGAATTTACTTCGTGTGAATTTTATTGGGCATATGCT	3557
KRS4TTC	TATGAAATTGGTAAAGTATTTAGATTCGAAGGTATAGATAATACACATAATCCTGAATTTACTTCGTGTGAATTTTATTGGGCATATGCT	599
KRS4TTA	TATGAAATTGGTAAAGTATTTAGATTAGAAGGTATAGATAATACACATAATCCTGAATTTACTTCGTGTGAATTTTATTGGGCATATGCT	771
KRS4TTG	TATGAAATTGGTAAAGTATTTAGATTGGAAGGTATAGATAATACACATAATCCTGAATTTACTTCGTGTGAATTTTATTGGGCATATGCT	1199
KRS4CTT	TATGAAATTGGTAAAGTATTTAGACTTGAAGGTATAGATAATACACATAATCCTGAATTTACTTCGTGTGAATTTTATTGGGCATATGCT	862
KRS4CTC	TATGAAATTGGTAAAGTATTTAGACTCGAAGGTATAGATAATACACATAATCCTGAATTTACTTCGTGTGAATTTTATTGGGCATATGCT	256
KRS4CTA	TATGAAATTGGTAAAGTATTTAGACTAGAAGGTATAGATAATACACATAATCCTGAATTTACTTCGTGTGAATTTTATTGGGCATATGCT	504
KRS4CTG	TATGAAATTGGTAAAGTATTTAGACTGGAAGGTATAGATAATACACATAATCCTGAATTTACTTCGTGTGAATTTTATTGGGCATATGCT	414
KRS4ATT	TATGAAATTGGTAAAGTATTTAGAATTGAAGGTATAGATAATACACATAATCCTGAATTTACTTCGTGTGAATTTTATTGGGCATATGCT	861
KRS4ATC	TATGAAATTGGTAAAGTATTTAGAATCGAAGGTATAGATAATACACATAATCCTGAATTTACTTCGTGTGAATTTTATTGGGCATATGCT	395
KRS4ATA	TATGAAATTGGTAAAGTATTTAGAATAGAAGGTATAGATAATACACATAATCCTGAATTTACTTCGTGTGAATTTTATTGGGCATATGCT	536
KRS4ATG	TATGAAATTGGTAAAGTATTTAGAATGGAAGGTATAGATAATACACATAATCCTGAATTTACTTCGTGTGAATTTTATTGGGCATATGCT	384
KRS4GTT	TATGAAATTGGTAAAGTATTTAGAGTTGAAGGTATAGATAATACACATAATCCTGAATTTACTTCGTGTGAATTTTATTGGGCATATGCT	842
KRS4GTC	TATGAAATTGGTAAAGTATTTAGAGTCGAAGGTATAGATAATACACATAATCCTGAATTTACTTCGTGTGAATTTTATTGGGCATATGCT	261
KRS4GTA	TATGAAATTGGTAAAGTATTTAGAGTAGAAGGTATAGATAATACACATAATCCTGAATTTACTTCGTGTGAATTTTATTGGGCATATGCT	455
KRS4GTG	TATGAAATTGGTAAAGTATTTAGAGTGGAAGGTATAGATAATACACATAATCCTGAATTTACTTCGTGTGAATTTTATTGGGCATATGCT	334
KRS4TCT	TATGAAATTGGTAAAGTATTTAGATCTGAAGGTATAGATAATACACATAATCCTGAATTTACTTCGTGTGAATTTTATTGGGCATATGCT	1093
KRS4TCC	TATGAAATTGGTAAAGTATTTAGATCCGAAGGTATAGATAATACACATAATCCTGAATTTACTTCGTGTGAATTTTATTGGGCATATGCT	358
KRS4TCA	TATGAAATTGGTAAAGTATTTAGATCAGAAGGTATAGATAATACACATAATCCTGAATTTACTTCGTGTGAATTTTATTGGGCATATGCT	623
KRS4TCG	TATGAAATTGGTAAAGTATTTAGATCGGAAGGTATAGATAATACACATAATCCTGAATTTACTTCGTGTGAATTTTATTGGGCATATGCT	298
KRS4CCT	TATGAAATTGGTAAAGTATTTAGACCTGAAGGTATAGATAATACACATAATCCTGAATTTACTTCGTGTGAATTTTATTGGGCATATGCT	398
KRS4CCC	TATGAAATTGGTAAAGTATTTAGACCCGAAGGTATAGATAATACACATAATCCTGAATTTACTTCGTGTGAATTTTATTGGGCATATGCT	359
KRS4CCA	TATGAAATTGGTAAAGTATTTAGACCAGAAGGTATAGATAATACACATAATCCTGAATTTACTTCGTGTGAATTTTATTGGGCATATGCT	645
KRS4CCG	TATGAAATTGGTAAAGTATTTAGACCGGAAGGTATAGATAATACACATAATCCTGAATTTACTTCGTGTGAATTTTATTGGGCATATGCT	205
KRS4ACT	TATGAAATTGGTAAAGTATTTAGAACTGAAGGTATAGATAATACACATAATCCTGAATTTACTTCGTGTGAATTTTATTGGGCATATGCT	461
KRS4ACC	TATGAAATTGGTAAAGTATTTAGAACCGAAGGTATAGATAATACACATAATCCTGAATTTACTTCGTGTGAATTTTATTGGGCATATGCT	340
KRS4ACA	TATGAAATTGGTAAAGTATTTAGAACAGAAGGTATAGATAATACACATAATCCTGAATTTACTTCGTGTGAATTTTATTGGGCATATGCT	775
KRS4ACG	TATGAAATTGGTAAAGTATTTAGAACGGAAGGTATAGATAATACACATAATCCTGAATTTACTTCGTGTGAATTTTATTGGGCATATGCT	248
KRS4GCT	TATGAAATTGGTAAAGTATTTAGAGCTGAAGGTATAGATAATACACATAATCCTGAATTTACTTCGTGTGAATTTTATTGGGCATATGCT	490
KRS4GCC	TATGAAATTGGTAAAGTATTTAGAGCCGAAGGTATAGATAATACACATAATCCTGAATTTACTTCGTGTGAATTTTATTGGGCATATGCT	274
KRS4GCA	TATGAAATTGGTAAAGTATTTAGAGCAGAAGGTATAGATAATACACATAATCCTGAATTTACTTCGTGTGAATTTTATTGGGCATATGCT	672
KRS4GCG	TATGAAATTGGTAAAGTATTTAGAGCGGAAGGTATAGATAATACACATAATCCTGAATTTACTTCGTGTGAATTTTATTGGGCATATGCT	373
KRS4TAT	TATGAAATTGGTAAAGTATTTAGATATGAAGGTATAGATAATACACATAATCCTGAATTTACTTCGTGTGAATTTTATTGGGCATATGCT	1042
KRS4TAC	TATGAAATTGGTAAAGTATTTAGATACGAAGGTATAGATAATACACATAATCCTGAATTTACTTCGTGTGAATTTTATTGGGCATATGCT	454
KRS4TAA	TATGAAATTGGTAAAGTATTTAGATAAGAAGGTATAGATAATACACATAATCCTGAATTTACTTCGTGTGAATTTTATTGGGCATATGCT	771
KRS4TAG	TATGAAATTGGTAAAGTATTTAGATAGGAAGGTATAGATAATACACATAATCCTGAATTTACTTCGTGTGAATTTTATTGGGCATATGCT	412
KRS4CAT	TATGAAATTGGTAAAGTATTTAGACATGAAGGTATAGATAATACACATAATCCTGAATTTACTTCGTGTGAATTTTATTGGGCATATGCT	579
KRS4CAC	TATGAAATTGGTAAAGTATTTAGACACGAAGGTATAGATAATACACATAATCCTGAATTTACTTCGTGTGAATTTTATTGGGCATATGCT	876
KRS4CAA	TATGAAATTGGTAAAGTATTTAGACAAGAAGGTATAGATAATACACATAATCCTGAATTTACTTCGTGTGAATTTTATTGGGCATATGCT	1028
KRS4CAG	TATGAAATTGGTAAAGTATTTAGACAGGAAGGTATAGATAATACACATAATCCTGAATTTACTTCGTGTGAATTTTATTGGGCATATGCT	367
KRS4AAT	TATGAAATTGGTAAAGTATTTAGAAATGAAGGTATAGATAATACACATAATCCTGAATTTACTTCGTGTGAATTTTATTGGGCATATGCT	53004
KRS4AAC	TATGAAATTGGTAAAGTATTTAGAAACGAAGGTATAGATAATACACATAATCCTGAATTTACTTCGTGTGAATTTTATTGGGCATATGCT	551
KRS4AAA	TATGAAATTGGTAAAGTATTTAGAAAAGAAGGTATAGATAATACACATAATCCTGAATTTACTTCGTGTGAATTTTATTGGGCATATGCT	864
KRS4AAG	TATGAAATTGGTAAAGTATTTAGAAAGGAAGGTATAGATAATACACATAATCCTGAATTTACTTCGTGTGAATTTTATTGGGCATATGCT	415
KRS4GAT	TATGAAATTGGTAAAGTATTTAGAGATGAAGGTATAGATAATACACATAATCCTGAATTTACTTCGTGTGAATTTTATTGGGCATATGCT	474
KRS4GAC	TATGAAATTGGTAAAGTATTTAGAGACGAAGGTATAGATAATACACATAATCCTGAATTTACTTCGTGTGAATTTTATTGGGCATATGCT	378
KRS4GAA	TATGAAATTGGTAAAGTATTTAGAGAAGAAGGTATAGATAATACACATAATCCTGAATTTACTTCGTGTGAATTTTATTGGGCATATGCT	471
KRS4GAG	TATGAAATTGGTAAAGTATTTAGAGAGGAAGGTATAGATAATACACATAATCCTGAATTTACTTCGTGTGAATTTTATTGGGCATATGCT	237
KRS4TGT	TATGAAATTGGTAAAGTATTTAGATGTGAAGGTATAGATAATACACATAATCCTGAATTTACTTCGTGTGAATTTTATTGGGCATATGCT	1587
KRS4TGC	TATGAAATTGGTAAAGTATTTAGATGCGAAGGTATAGATAATACACATAATCCTGAATTTACTTCGTGTGAATTTTATTGGGCATATGCT	416
KRS4TGA	TATGAAATTGGTAAAGTATTTAGATGAGAAGGTATAGATAATACACATAATCCTGAATTTACTTCGTGTGAATTTTATTGGGCATATGCT	525
KRS4TGG	TATGAAATTGGTAAAGTATTTAGATGGGAAGGTATAGATAATACACATAATCCTGAATTTACTTCGTGTGAATTTTATTGGGCATATGCT	371
KRS4CGT	TATGAAATTGGTAAAGTATTTAGACGTGAAGGTATAGATAATACACATAATCCTGAATTTACTTCGTGTGAATTTTATTGGGCATATGCT	320
KRS4CGC	TATGAAATTGGTAAAGTATTTAGACGCGAAGGTATAGATAATACACATAATCCTGAATTTACTTCGTGTGAATTTTATTGGGCATATGCT	354
KRS4CGA	TATGAAATTGGTAAAGTATTTAGACGAGAAGGTATAGATAATACACATAATCCTGAATTTACTTCGTGTGAATTTTATTGGGCATATGCT	379
KRS4CGG	TATGAAATTGGTAAAGTATTTAGACGGGAAGGTATAGATAATACACATAATCCTGAATTTACTTCGTGTGAATTTTATTGGGCATATGCT	191
KRS4AGT	TATGAAATTGGTAAAGTATTTAGAAGTGAAGGTATAGATAATACACATAATCCTGAATTTACTTCGTGTGAATTTTATTGGGCATATGCT	369
KRS4AGC	TATGAAATTGGTAAAGTATTTAGAAGCGAAGGTATAGATAATACACATAATCCTGAATTTACTTCGTGTGAATTTTATTGGGCATATGCT	337
KRS4AGA	TATGAAATTGGTAAAGTATTTAGAAGAGAAGGTATAGATAATACACATAATCCTGAATTTACTTCGTGTGAATTTTATTGGGCATATGCT	426
KRS4AGG	TATGAAATTGGTAAAGTATTTAGAAGGGAAGGTATAGATAATACACATAATCCTGAATTTACTTCGTGTGAATTTTATTGGGCATATGCT	257
KRS4GGT	TATGAAATTGGTAAAGTATTTAGAGGTGAAGGTATAGATAATACACATAATCCTGAATTTACTTCGTGTGAATTTTATTGGGCATATGCT	308
KRS4GGC	TATGAAATTGGTAAAGTATTTAGAGGCGAAGGTATAGATAATACACATAATCCTGAATTTACTTCGTGTGAATTTTATTGGGCATATGCT	187
KRS4GGA	TATGAAATTGGTAAAGTATTTAGAGGAGAAGGTATAGATAATACACATAATCCTGAATTTACTTCGTGTGAATTTTATTGGGCATATGCT	303
KRS4GGG	TATGAAATTGGTAAAGTATTTAGAGGGGAAGGTATAGATAATACACATAATCCTGAATTTACTTCGTGTGAATTTTATTGGGCATATGCT	143
KRS5TTT	TATGAAATTGGTAAAGTATTTAGAAATTTTGGTATAGATAATACACATAATCCTGAATTTACTTCGTGTGAATTTTATTGGGCATATGCT	12311
KRS5TTC	TATGAAATTGGTAAAGTATTTAGAAATTTCGGTATAGATAATACACATAATCCTGAATTTACTTCGTGTGAATTTTATTGGGCATATGCT	1758
KRS5TTA	TATGAAATTGGTAAAGTATTTAGAAATTTAGGTATAGATAATACACATAATCCTGAATTTACTTCGTGTGAATTTTATTGGGCATATGCT	2443
KRS5TTG	TATGAAATTGGTAAAGTATTTAGAAATTTGGGTATAGATAATACACATAATCCTGAATTTACTTCGTGTGAATTTTATTGGGCATATGCT	3797
KRS5CTT	TATGAAATTGGTAAAGTATTTAGAAATCTTGGTATAGATAATACACATAATCCTGAATTTACTTCGTGTGAATTTTATTGGGCATATGCT	3996
KRS5CTC	TATGAAATTGGTAAAGTATTTAGAAATCTCGGTATAGATAATACACATAATCCTGAATTTACTTCGTGTGAATTTTATTGGGCATATGCT	950
KRS5CTA	TATGAAATTGGTAAAGTATTTAGAAATCTAGGTATAGATAATACACATAATCCTGAATTTACTTCGTGTGAATTTTATTGGGCATATGCT	1462
KRS5CTG	TATGAAATTGGTAAAGTATTTAGAAATCTGGGTATAGATAATACACATAATCCTGAATTTACTTCGTGTGAATTTTATTGGGCATATGCT	1642
KRS5ATT	TATGAAATTGGTAAAGTATTTAGAAATATTGGTATAGATAATACACATAATCCTGAATTTACTTCGTGTGAATTTTATTGGGCATATGCT	5859
KRS5ATC	TATGAAATTGGTAAAGTATTTAGAAATATCGGTATAGATAATACACATAATCCTGAATTTACTTCGTGTGAATTTTATTGGGCATATGCT	1801
KRS5ATA	TATGAAATTGGTAAAGTATTTAGAAATATAGGTATAGATAATACACATAATCCTGAATTTACTTCGTGTGAATTTTATTGGGCATATGCT	2460
KRS5ATG	TATGAAATTGGTAAAGTATTTAGAAATATGGGTATAGATAATACACATAATCCTGAATTTACTTCGTGTGAATTTTATTGGGCATATGCT	2026
KRS5GTT	TATGAAATTGGTAAAGTATTTAGAAATGTTGGTATAGATAATACACATAATCCTGAATTTACTTCGTGTGAATTTTATTGGGCATATGCT	4220
KRS5GTC	TATGAAATTGGTAAAGTATTTAGAAATGTCGGTATAGATAATACACATAATCCTGAATTTACTTCGTGTGAATTTTATTGGGCATATGCT	1022
KRS5GTA	TATGAAATTGGTAAAGTATTTAGAAATGTAGGTATAGATAATACACATAATCCTGAATTTACTTCGTGTGAATTTTATTGGGCATATGCT	1445
KRS5GTG	TATGAAATTGGTAAAGTATTTAGAAATGTGGGTATAGATAATACACATAATCCTGAATTTACTTCGTGTGAATTTTATTGGGCATATGCT	1337
KRS5TCT	TATGAAATTGGTAAAGTATTTAGAAATTCTGGTATAGATAATACACATAATCCTGAATTTACTTCGTGTGAATTTTATTGGGCATATGCT	3089
KRS5TCC	TATGAAATTGGTAAAGTATTTAGAAATTCCGGTATAGATAATACACATAATCCTGAATTTACTTCGTGTGAATTTTATTGGGCATATGCT	1301
KRS5TCA	TATGAAATTGGTAAAGTATTTAGAAATTCAGGTATAGATAATACACATAATCCTGAATTTACTTCGTGTGAATTTTATTGGGCATATGCT	2331
KRS5TCG	TATGAAATTGGTAAAGTATTTAGAAATTCGGGTATAGATAATACACATAATCCTGAATTTACTTCGTGTGAATTTTATTGGGCATATGCT	841
KRS5CCT	TATGAAATTGGTAAAGTATTTAGAAATCCTGGTATAGATAATACACATAATCCTGAATTTACTTCGTGTGAATTTTATTGGGCATATGCT	1602
KRS5CCC	TATGAAATTGGTAAAGTATTTAGAAATCCCGGTATAGATAATACACATAATCCTGAATTTACTTCGTGTGAATTTTATTGGGCATATGCT	1092
KRS5CCA	TATGAAATTGGTAAAGTATTTAGAAATCCAGGTATAGATAATACACATAATCCTGAATTTACTTCGTGTGAATTTTATTGGGCATATGCT	2112
KRS5CCG	TATGAAATTGGTAAAGTATTTAGAAATCCGGGTATAGATAATACACATAATCCTGAATTTACTTCGTGTGAATTTTATTGGGCATATGCT	802
KRS5ACT	TATGAAATTGGTAAAGTATTTAGAAATACTGGTATAGATAATACACATAATCCTGAATTTACTTCGTGTGAATTTTATTGGGCATATGCT	2129
KRS5ACC	TATGAAATTGGTAAAGTATTTAGAAATACCGGTATAGATAATACACATAATCCTGAATTTACTTCGTGTGAATTTTATTGGGCATATGCT	1886
KRS5ACA	TATGAAATTGGTAAAGTATTTAGAAATACAGGTATAGATAATACACATAATCCTGAATTTACTTCGTGTGAATTTTATTGGGCATATGCT	3363
KRS5ACG	TATGAAATTGGTAAAGTATTTAGAAATACGGGTATAGATAATACACATAATCCTGAATTTACTTCGTGTGAATTTTATTGGGCATATGCT	1082
KRS5GCT	TATGAAATTGGTAAAGTATTTAGAAATGCTGGTATAGATAATACACATAATCCTGAATTTACTTCGTGTGAATTTTATTGGGCATATGCT	1904
KRS5GCC	TATGAAATTGGTAAAGTATTTAGAAATGCCGGTATAGATAATACACATAATCCTGAATTTACTTCGTGTGAATTTTATTGGGCATATGCT	1122
KRS5GCA	TATGAAATTGGTAAAGTATTTAGAAATGCAGGTATAGATAATACACATAATCCTGAATTTACTTCGTGTGAATTTTATTGGGCATATGCT	1989
KRS5GCG	TATGAAATTGGTAAAGTATTTAGAAATGCGGGTATAGATAATACACATAATCCTGAATTTACTTCGTGTGAATTTTATTGGGCATATGCT	791
KRS5TAT	TATGAAATTGGTAAAGTATTTAGAAATTATGGTATAGATAATACACATAATCCTGAATTTACTTCGTGTGAATTTTATTGGGCATATGCT	3324
KRS5TAC	TATGAAATTGGTAAAGTATTTAGAAATTACGGTATAGATAATACACATAATCCTGAATTTACTTCGTGTGAATTTTATTGGGCATATGCT	1522
KRS5TAA	TATGAAATTGGTAAAGTATTTAGAAATTAAGGTATAGATAATACACATAATCCTGAATTTACTTCGTGTGAATTTTATTGGGCATATGCT	1933
KRS5TAG	TATGAAATTGGTAAAGTATTTAGAAATTAGGGTATAGATAATACACATAATCCTGAATTTACTTCGTGTGAATTTTATTGGGCATATGCT	1290
KRS5CAT	TATGAAATTGGTAAAGTATTTAGAAATCATGGTATAGATAATACACATAATCCTGAATTTACTTCGTGTGAATTTTATTGGGCATATGCT	2231
KRS5CAC	TATGAAATTGGTAAAGTATTTAGAAATCACGGTATAGATAATACACATAATCCTGAATTTACTTCGTGTGAATTTTATTGGGCATATGCT	1438
KRS5CAA	TATGAAATTGGTAAAGTATTTAGAAATCAAGGTATAGATAATACACATAATCCTGAATTTACTTCGTGTGAATTTTATTGGGCATATGCT	1889
KRS5CAG	TATGAAATTGGTAAAGTATTTAGAAATCAGGGTATAGATAATACACATAATCCTGAATTTACTTCGTGTGAATTTTATTGGGCATATGCT	1233
KRS5AAT	TATGAAATTGGTAAAGTATTTAGAAATAATGGTATAGATAATACACATAATCCTGAATTTACTTCGTGTGAATTTTATTGGGCATATGCT	2539
KRS5AAC	TATGAAATTGGTAAAGTATTTAGAAATAACGGTATAGATAATACACATAATCCTGAATTTACTTCGTGTGAATTTTATTGGGCATATGCT	2058
KRS5AAA	TATGAAATTGGTAAAGTATTTAGAAATAAAGGTATAGATAATACACATAATCCTGAATTTACTTCGTGTGAATTTTATTGGGCATATGCT	2858
KRS5AAG	TATGAAATTGGTAAAGTATTTAGAAATAAGGGTATAGATAATACACATAATCCTGAATTTACTTCGTGTGAATTTTATTGGGCATATGCT	1464
KRS5GAT	TATGAAATTGGTAAAGTATTTAGAAATGATGGTATAGATAATACACATAATCCTGAATTTACTTCGTGTGAATTTTATTGGGCATATGCT	1636
KRS5GAC	TATGAAATTGGTAAAGTATTTAGAAATGACGGTATAGATAATACACATAATCCTGAATTTACTTCGTGTGAATTTTATTGGGCATATGCT	1097
KRS5GAA	TATGAAATTGGTAAAGTATTTAGAAATGAAGGTATAGATAATACACATAATCCTGAATTTACTTCGTGTGAATTTTATTGGGCATATGCT	53004
KRS5GAG	TATGAAATTGGTAAAGTATTTAGAAATGAGGGTATAGATAATACACATAATCCTGAATTTACTTCGTGTGAATTTTATTGGGCATATGCT	869
KRS5TGT	TATGAAATTGGTAAAGTATTTAGAAATTGTGGTATAGATAATACACATAATCCTGAATTTACTTCGTGTGAATTTTATTGGGCATATGCT	4601
KRS5TGC	TATGAAATTGGTAAAGTATTTAGAAATTGCGGTATAGATAATACACATAATCCTGAATTTACTTCGTGTGAATTTTATTGGGCATATGCT	1445
KRS5TGA	TATGAAATTGGTAAAGTATTTAGAAATTGAGGTATAGATAATACACATAATCCTGAATTTACTTCGTGTGAATTTTATTGGGCATATGCT	1402
KRS5TGG	TATGAAATTGGTAAAGTATTTAGAAATTGGGGTATAGATAATACACATAATCCTGAATTTACTTCGTGTGAATTTTATTGGGCATATGCT	1053
KRS5CGT	TATGAAATTGGTAAAGTATTTAGAAATCGTGGTATAGATAATACACATAATCCTGAATTTACTTCGTGTGAATTTTATTGGGCATATGCT	1149
KRS5CGC	TATGAAATTGGTAAAGTATTTAGAAATCGCGGTATAGATAATACACATAATCCTGAATTTACTTCGTGTGAATTTTATTGGGCATATGCT	1100
KRS5CGA	TATGAAATTGGTAAAGTATTTAGAAATCGAGGTATAGATAATACACATAATCCTGAATTTACTTCGTGTGAATTTTATTGGGCATATGCT	1166
KRS5CGG	TATGAAATTGGTAAAGTATTTAGAAATCGGGGTATAGATAATACACATAATCCTGAATTTACTTCGTGTGAATTTTATTGGGCATATGCT	546
KRS5AGT	TATGAAATTGGTAAAGTATTTAGAAATAGTGGTATAGATAATACACATAATCCTGAATTTACTTCGTGTGAATTTTATTGGGCATATGCT	1817
KRS5AGC	TATGAAATTGGTAAAGTATTTAGAAATAGCGGTATAGATAATACACATAATCCTGAATTTACTTCGTGTGAATTTTATTGGGCATATGCT	1442
KRS5AGA	TATGAAATTGGTAAAGTATTTAGAAATAGAGGTATAGATAATACACATAATCCTGAATTTACTTCGTGTGAATTTTATTGGGCATATGCT	1834
KRS5AGG	TATGAAATTGGTAAAGTATTTAGAAATAGGGGTATAGATAATACACATAATCCTGAATTTACTTCGTGTGAATTTTATTGGGCATATGCT	1064
KRS5GGT	TATGAAATTGGTAAAGTATTTAGAAATGGTGGTATAGATAATACACATAATCCTGAATTTACTTCGTGTGAATTTTATTGGGCATATGCT	1066
KRS5GGC	TATGAAATTGGTAAAGTATTTAGAAATGGCGGTATAGATAATACACATAATCCTGAATTTACTTCGTGTGAATTTTATTGGGCATATGCT	798
KRS5GGA	TATGAAATTGGTAAAGTATTTAGAAATGGAGGTATAGATAATACACATAATCCTGAATTTACTTCGTGTGAATTTTATTGGGCATATGCT	870
KRS5GGG	TATGAAATTGGTAAAGTATTTAGAAATGGGGGTATAGATAATACACATAATCCTGAATTTACTTCGTGTGAATTTTATTGGGCATATGCT	551
KRS6TTT	TATGAAATTGGTAAAGTATTTAGAAATGAATTTATAGATAATACACATAATCCTGAATTTACTTCGTGTGAATTTTATTGGGCATATGCT	16774
KRS6TTC	TATGAAATTGGTAAAGTATTTAGAAATGAATTCATAGATAATACACATAATCCTGAATTTACTTCGTGTGAATTTTATTGGGCATATGCT	4414
KRS6TTA	TATGAAATTGGTAAAGTATTTAGAAATGAATTAATAGATAATACACATAATCCTGAATTTACTTCGTGTGAATTTTATTGGGCATATGCT	4302
KRS6TTG	TATGAAATTGGTAAAGTATTTAGAAATGAATTGATAGATAATACACATAATCCTGAATTTACTTCGTGTGAATTTTATTGGGCATATGCT	1856
KRS6CTT	TATGAAATTGGTAAAGTATTTAGAAATGAACTTATAGATAATACACATAATCCTGAATTTACTTCGTGTGAATTTTATTGGGCATATGCT	2029
KRS6CTC	TATGAAATTGGTAAAGTATTTAGAAATGAACTCATAGATAATACACATAATCCTGAATTTACTTCGTGTGAATTTTATTGGGCATATGCT	901
KRS6CTA	TATGAAATTGGTAAAGTATTTAGAAATGAACTAATAGATAATACACATAATCCTGAATTTACTTCGTGTGAATTTTATTGGGCATATGCT	1437
KRS6CTG	TATGAAATTGGTAAAGTATTTAGAAATGAACTGATAGATAATACACATAATCCTGAATTTACTTCGTGTGAATTTTATTGGGCATATGCT	825
KRS6ATT	TATGAAATTGGTAAAGTATTTAGAAATGAAATTATAGATAATACACATAATCCTGAATTTACTTCGTGTGAATTTTATTGGGCATATGCT	2956
KRS6ATC	TATGAAATTGGTAAAGTATTTAGAAATGAAATCATAGATAATACACATAATCCTGAATTTACTTCGTGTGAATTTTATTGGGCATATGCT	1269
KRS6ATA	TATGAAATTGGTAAAGTATTTAGAAATGAAATAATAGATAATACACATAATCCTGAATTTACTTCGTGTGAATTTTATTGGGCATATGCT	2270
KRS6ATG	TATGAAATTGGTAAAGTATTTAGAAATGAAATGATAGATAATACACATAATCCTGAATTTACTTCGTGTGAATTTTATTGGGCATATGCT	962
KRS6GTT	TATGAAATTGGTAAAGTATTTAGAAATGAAGTTATAGATAATACACATAATCCTGAATTTACTTCGTGTGAATTTTATTGGGCATATGCT	20350
KRS6GTC	TATGAAATTGGTAAAGTATTTAGAAATGAAGTCATAGATAATACACATAATCCTGAATTTACTTCGTGTGAATTTTATTGGGCATATGCT	1099
KRS6GTA	TATGAAATTGGTAAAGTATTTAGAAATGAAGTAATAGATAATACACATAATCCTGAATTTACTTCGTGTGAATTTTATTGGGCATATGCT	1456
KRS6GTG	TATGAAATTGGTAAAGTATTTAGAAATGAAGTGATAGATAATACACATAATCCTGAATTTACTTCGTGTGAATTTTATTGGGCATATGCT	612
KRS6TCT	TATGAAATTGGTAAAGTATTTAGAAATGAATCTATAGATAATACACATAATCCTGAATTTACTTCGTGTGAATTTTATTGGGCATATGCT	3561
KRS6TCC	TATGAAATTGGTAAAGTATTTAGAAATGAATCCATAGATAATACACATAATCCTGAATTTACTTCGTGTGAATTTTATTGGGCATATGCT	1321
KRS6TCA	TATGAAATTGGTAAAGTATTTAGAAATGAATCAATAGATAATACACATAATCCTGAATTTACTTCGTGTGAATTTTATTGGGCATATGCT	1805
KRS6TCG	TATGAAATTGGTAAAGTATTTAGAAATGAATCGATAGATAATACACATAATCCTGAATTTACTTCGTGTGAATTTTATTGGGCATATGCT	361
KRS6CCT	TATGAAATTGGTAAAGTATTTAGAAATGAACCTATAGATAATACACATAATCCTGAATTTACTTCGTGTGAATTTTATTGGGCATATGCT	799
KRS6CCC	TATGAAATTGGTAAAGTATTTAGAAATGAACCCATAGATAATACACATAATCCTGAATTTACTTCGTGTGAATTTTATTGGGCATATGCT	824
KRS6CCA	TATGAAATTGGTAAAGTATTTAGAAATGAACCAATAGATAATACACATAATCCTGAATTTACTTCGTGTGAATTTTATTGGGCATATGCT	1626
KRS6CCG	TATGAAATTGGTAAAGTATTTAGAAATGAACCGATAGATAATACACATAATCCTGAATTTACTTCGTGTGAATTTTATTGGGCATATGCT	454
KRS6ACT	TATGAAATTGGTAAAGTATTTAGAAATGAAACTATAGATAATACACATAATCCTGAATTTACTTCGTGTGAATTTTATTGGGCATATGCT	1334
KRS6ACC	TATGAAATTGGTAAAGTATTTAGAAATGAAACCATAGATAATACACATAATCCTGAATTTACTTCGTGTGAATTTTATTGGGCATATGCT	1615
KRS6ACA	TATGAAATTGGTAAAGTATTTAGAAATGAAACAATAGATAATACACATAATCCTGAATTTACTTCGTGTGAATTTTATTGGGCATATGCT	2285
KRS6ACG	TATGAAATTGGTAAAGTATTTAGAAATGAAACGATAGATAATACACATAATCCTGAATTTACTTCGTGTGAATTTTATTGGGCATATGCT	657
KRS6GCT	TATGAAATTGGTAAAGTATTTAGAAATGAAGCTATAGATAATACACATAATCCTGAATTTACTTCGTGTGAATTTTATTGGGCATATGCT	991
KRS6GCC	TATGAAATTGGTAAAGTATTTAGAAATGAAGCCATAGATAATACACATAATCCTGAATTTACTTCGTGTGAATTTTATTGGGCATATGCT	1045
KRS6GCA	TATGAAATTGGTAAAGTATTTAGAAATGAAGCAATAGATAATACACATAATCCTGAATTTACTTCGTGTGAATTTTATTGGGCATATGCT	1093
KRS6GCG	TATGAAATTGGTAAAGTATTTAGAAATGAAGCGATAGATAATACACATAATCCTGAATTTACTTCGTGTGAATTTTATTGGGCATATGCT	621
KRS6TAT	TATGAAATTGGTAAAGTATTTAGAAATGAATATATAGATAATACACATAATCCTGAATTTACTTCGTGTGAATTTTATTGGGCATATGCT	3401
KRS6TAC	TATGAAATTGGTAAAGTATTTAGAAATGAATACATAGATAATACACATAATCCTGAATTTACTTCGTGTGAATTTTATTGGGCATATGCT	1761
KRS6TAA	TATGAAATTGGTAAAGTATTTAGAAATGAATAAATAGATAATACACATAATCCTGAATTTACTTCGTGTGAATTTTATTGGGCATATGCT	2613
KRS6TAG	TATGAAATTGGTAAAGTATTTAGAAATGAATAGATAGATAATACACATAATCCTGAATTTACTTCGTGTGAATTTTATTGGGCATATGCT	866
KRS6CAT	TATGAAATTGGTAAAGTATTTAGAAATGAACATATAGATAATACACATAATCCTGAATTTACTTCGTGTGAATTTTATTGGGCATATGCT	2267
KRS6CAC	TATGAAATTGGTAAAGTATTTAGAAATGAACACATAGATAATACACATAATCCTGAATTTACTTCGTGTGAATTTTATTGGGCATATGCT	1911
KRS6CAA	TATGAAATTGGTAAAGTATTTAGAAATGAACAAATAGATAATACACATAATCCTGAATTTACTTCGTGTGAATTTTATTGGGCATATGCT	3266
KRS6CAG	TATGAAATTGGTAAAGTATTTAGAAATGAACAGATAGATAATACACATAATCCTGAATTTACTTCGTGTGAATTTTATTGGGCATATGCT	1329
KRS6AAT	TATGAAATTGGTAAAGTATTTAGAAATGAAAATATAGATAATACACATAATCCTGAATTTACTTCGTGTGAATTTTATTGGGCATATGCT	2170
KRS6AAC	TATGAAATTGGTAAAGTATTTAGAAATGAAAACATAGATAATACACATAATCCTGAATTTACTTCGTGTGAATTTTATTGGGCATATGCT	2155
KRS6AAA	TATGAAATTGGTAAAGTATTTAGAAATGAAAAAATAGATAATACACATAATCCTGAATTTACTTCGTGTGAATTTTATTGGGCATATGCT	2627
KRS6AAG	TATGAAATTGGTAAAGTATTTAGAAATGAAAAGATAGATAATACACATAATCCTGAATTTACTTCGTGTGAATTTTATTGGGCATATGCT	1377
KRS6GAT	TATGAAATTGGTAAAGTATTTAGAAATGAAGATATAGATAATACACATAATCCTGAATTTACTTCGTGTGAATTTTATTGGGCATATGCT	1106
KRS6GAC	TATGAAATTGGTAAAGTATTTAGAAATGAAGACATAGATAATACACATAATCCTGAATTTACTTCGTGTGAATTTTATTGGGCATATGCT	1349
KRS6GAA	TATGAAATTGGTAAAGTATTTAGAAATGAAGAAATAGATAATACACATAATCCTGAATTTACTTCGTGTGAATTTTATTGGGCATATGCT	1183
KRS6GAG	TATGAAATTGGTAAAGTATTTAGAAATGAAGAGATAGATAATACACATAATCCTGAATTTACTTCGTGTGAATTTTATTGGGCATATGCT	788
KRS6TGT	TATGAAATTGGTAAAGTATTTAGAAATGAATGTATAGATAATACACATAATCCTGAATTTACTTCGTGTGAATTTTATTGGGCATATGCT	3178
KRS6TGC	TATGAAATTGGTAAAGTATTTAGAAATGAATGCATAGATAATACACATAATCCTGAATTTACTTCGTGTGAATTTTATTGGGCATATGCT	1329
KRS6TGA	TATGAAATTGGTAAAGTATTTAGAAATGAATGAATAGATAATACACATAATCCTGAATTTACTTCGTGTGAATTTTATTGGGCATATGCT	1153
KRS6TGG	TATGAAATTGGTAAAGTATTTAGAAATGAATGGATAGATAATACACATAATCCTGAATTTACTTCGTGTGAATTTTATTGGGCATATGCT	693
KRS6CGT	TATGAAATTGGTAAAGTATTTAGAAATGAACGTATAGATAATACACATAATCCTGAATTTACTTCGTGTGAATTTTATTGGGCATATGCT	669
KRS6CGC	TATGAAATTGGTAAAGTATTTAGAAATGAACGCATAGATAATACACATAATCCTGAATTTACTTCGTGTGAATTTTATTGGGCATATGCT	782
KRS6CGA	TATGAAATTGGTAAAGTATTTAGAAATGAACGAATAGATAATACACATAATCCTGAATTTACTTCGTGTGAATTTTATTGGGCATATGCT	677
KRS6CGG	TATGAAATTGGTAAAGTATTTAGAAATGAACGGATAGATAATACACATAATCCTGAATTTACTTCGTGTGAATTTTATTGGGCATATGCT	465
KRS6AGT	TATGAAATTGGTAAAGTATTTAGAAATGAAAGTATAGATAATACACATAATCCTGAATTTACTTCGTGTGAATTTTATTGGGCATATGCT	955
KRS6AGC	TATGAAATTGGTAAAGTATTTAGAAATGAAAGCATAGATAATACACATAATCCTGAATTTACTTCGTGTGAATTTTATTGGGCATATGCT	949
KRS6AGA	TATGAAATTGGTAAAGTATTTAGAAATGAAAGAATAGATAATACACATAATCCTGAATTTACTTCGTGTGAATTTTATTGGGCATATGCT	1316
KRS6AGG	TATGAAATTGGTAAAGTATTTAGAAATGAAAGGATAGATAATACACATAATCCTGAATTTACTTCGTGTGAATTTTATTGGGCATATGCT	665
KRS6GGT	TATGAAATTGGTAAAGTATTTAGAAATGAAGGTATAGATAATACACATAATCCTGAATTTACTTCGTGTGAATTTTATTGGGCATATGCT	53004
KRS6GGC	TATGAAATTGGTAAAGTATTTAGAAATGAAGGCATAGATAATACACATAATCCTGAATTTACTTCGTGTGAATTTTATTGGGCATATGCT	732
KRS6GGA	TATGAAATTGGTAAAGTATTTAGAAATGAAGGAATAGATAATACACATAATCCTGAATTTACTTCGTGTGAATTTTATTGGGCATATGCT	792
KRS6GGG	TATGAAATTGGTAAAGTATTTAGAAATGAAGGGATAGATAATACACATAATCCTGAATTTACTTCGTGTGAATTTTATTGGGCATATGCT	407
KRS7TTT	TATGAAATTGGTAAAGTATTTAGAAATGAAGGTTTTGATAATACACATAATCCTGAATTTACTTCGTGTGAATTTTATTGGGCATATGCT	6520
KRS7TTC	TATGAAATTGGTAAAGTATTTAGAAATGAAGGTTTCGATAATACACATAATCCTGAATTTACTTCGTGTGAATTTTATTGGGCATATGCT	1298
KRS7TTA	TATGAAATTGGTAAAGTATTTAGAAATGAAGGTTTAGATAATACACATAATCCTGAATTTACTTCGTGTGAATTTTATTGGGCATATGCT	1159
KRS7TTG	TATGAAATTGGTAAAGTATTTAGAAATGAAGGTTTGGATAATACACATAATCCTGAATTTACTTCGTGTGAATTTTATTGGGCATATGCT	1933
KRS7CTT	TATGAAATTGGTAAAGTATTTAGAAATGAAGGTCTTGATAATACACATAATCCTGAATTTACTTCGTGTGAATTTTATTGGGCATATGCT	1982
KRS7CTC	TATGAAATTGGTAAAGTATTTAGAAATGAAGGTCTCGATAATACACATAATCCTGAATTTACTTCGTGTGAATTTTATTGGGCATATGCT	323
KRS7CTA	TATGAAATTGGTAAAGTATTTAGAAATGAAGGTCTAGATAATACACATAATCCTGAATTTACTTCGTGTGAATTTTATTGGGCATATGCT	561
KRS7CTG	TATGAAATTGGTAAAGTATTTAGAAATGAAGGTCTGGATAATACACATAATCCTGAATTTACTTCGTGTGAATTTTATTGGGCATATGCT	518
KRS7ATT	TATGAAATTGGTAAAGTATTTAGAAATGAAGGTATTGATAATACACATAATCCTGAATTTACTTCGTGTGAATTTTATTGGGCATATGCT	1759
KRS7ATC	TATGAAATTGGTAAAGTATTTAGAAATGAAGGTATCGATAATACACATAATCCTGAATTTACTTCGTGTGAATTTTATTGGGCATATGCT	744
KRS7ATA	TATGAAATTGGTAAAGTATTTAGAAATGAAGGTATAGATAATACACATAATCCTGAATTTACTTCGTGTGAATTTTATTGGGCATATGCT	53004
KRS7ATG	TATGAAATTGGTAAAGTATTTAGAAATGAAGGTATGGATAATACACATAATCCTGAATTTACTTCGTGTGAATTTTATTGGGCATATGCT	784
KRS7GTT	TATGAAATTGGTAAAGTATTTAGAAATGAAGGTGTTGATAATACACATAATCCTGAATTTACTTCGTGTGAATTTTATTGGGCATATGCT	836
KRS7GTC	TATGAAATTGGTAAAGTATTTAGAAATGAAGGTGTCGATAATACACATAATCCTGAATTTACTTCGTGTGAATTTTATTGGGCATATGCT	738
KRS7GTA	TATGAAATTGGTAAAGTATTTAGAAATGAAGGTGTAGATAATACACATAATCCTGAATTTACTTCGTGTGAATTTTATTGGGCATATGCT	459
KRS7GTG	TATGAAATTGGTAAAGTATTTAGAAATGAAGGTGTGGATAATACACATAATCCTGAATTTACTTCGTGTGAATTTTATTGGGCATATGCT	760
KRS7TCT	TATGAAATTGGTAAAGTATTTAGAAATGAAGGTTCTGATAATACACATAATCCTGAATTTACTTCGTGTGAATTTTATTGGGCATATGCT	2203
KRS7TCC	TATGAAATTGGTAAAGTATTTAGAAATGAAGGTTCCGATAATACACATAATCCTGAATTTACTTCGTGTGAATTTTATTGGGCATATGCT	640
KRS7TCA	TATGAAATTGGTAAAGTATTTAGAAATGAAGGTTCAGATAATACACATAATCCTGAATTTACTTCGTGTGAATTTTATTGGGCATATGCT	885
KRS7TCG	TATGAAATTGGTAAAGTATTTAGAAATGAAGGTTCGGATAATACACATAATCCTGAATTTACTTCGTGTGAATTTTATTGGGCATATGCT	350
KRS7CCT	TATGAAATTGGTAAAGTATTTAGAAATGAAGGTCCTGATAATACACATAATCCTGAATTTACTTCGTGTGAATTTTATTGGGCATATGCT	566
KRS7CCC	TATGAAATTGGTAAAGTATTTAGAAATGAAGGTCCCGATAATACACATAATCCTGAATTTACTTCGTGTGAATTTTATTGGGCATATGCT	451
KRS7CCA	TATGAAATTGGTAAAGTATTTAGAAATGAAGGTCCAGATAATACACATAATCCTGAATTTACTTCGTGTGAATTTTATTGGGCATATGCT	711
KRS7CCG	TATGAAATTGGTAAAGTATTTAGAAATGAAGGTCCGGATAATACACATAATCCTGAATTTACTTCGTGTGAATTTTATTGGGCATATGCT	273
KRS7ACT	TATGAAATTGGTAAAGTATTTAGAAATGAAGGTACTGATAATACACATAATCCTGAATTTACTTCGTGTGAATTTTATTGGGCATATGCT	1120
KRS7ACC	TATGAAATTGGTAAAGTATTTAGAAATGAAGGTACCGATAATACACATAATCCTGAATTTACTTCGTGTGAATTTTATTGGGCATATGCT	1439
KRS7ACA	TATGAAATTGGTAAAGTATTTAGAAATGAAGGTACAGATAATACACATAATCCTGAATTTACTTCGTGTGAATTTTATTGGGCATATGCT	1918
KRS7ACG	TATGAAATTGGTAAAGTATTTAGAAATGAAGGTACGGATAATACACATAATCCTGAATTTACTTCGTGTGAATTTTATTGGGCATATGCT	344
KRS7GCT	TATGAAATTGGTAAAGTATTTAGAAATGAAGGTGCTGATAATACACATAATCCTGAATTTACTTCGTGTGAATTTTATTGGGCATATGCT	669
KRS7GCC	TATGAAATTGGTAAAGTATTTAGAAATGAAGGTGCCGATAATACACATAATCCTGAATTTACTTCGTGTGAATTTTATTGGGCATATGCT	482
KRS7GCA	TATGAAATTGGTAAAGTATTTAGAAATGAAGGTGCAGATAATACACATAATCCTGAATTTACTTCGTGTGAATTTTATTGGGCATATGCT	884
KRS7GCG	TATGAAATTGGTAAAGTATTTAGAAATGAAGGTGCGGATAATACACATAATCCTGAATTTACTTCGTGTGAATTTTATTGGGCATATGCT	267
KRS7TAT	TATGAAATTGGTAAAGTATTTAGAAATGAAGGTTATGATAATACACATAATCCTGAATTTACTTCGTGTGAATTTTATTGGGCATATGCT	1730
KRS7TAC	TATGAAATTGGTAAAGTATTTAGAAATGAAGGTTACGATAATACACATAATCCTGAATTTACTTCGTGTGAATTTTATTGGGCATATGCT	853
KRS7TAA	TATGAAATTGGTAAAGTATTTAGAAATGAAGGTTAAGATAATACACATAATCCTGAATTTACTTCGTGTGAATTTTATTGGGCATATGCT	1163
KRS7TAG	TATGAAATTGGTAAAGTATTTAGAAATGAAGGTTAGGATAATACACATAATCCTGAATTTACTTCGTGTGAATTTTATTGGGCATATGCT	540
KRS7CAT	TATGAAATTGGTAAAGTATTTAGAAATGAAGGTCATGATAATACACATAATCCTGAATTTACTTCGTGTGAATTTTATTGGGCATATGCT	968
KRS7CAC	TATGAAATTGGTAAAGTATTTAGAAATGAAGGTCACGATAATACACATAATCCTGAATTTACTTCGTGTGAATTTTATTGGGCATATGCT	903
KRS7CAA	TATGAAATTGGTAAAGTATTTAGAAATGAAGGTCAAGATAATACACATAATCCTGAATTTACTTCGTGTGAATTTTATTGGGCATATGCT	834
KRS7CAG	TATGAAATTGGTAAAGTATTTAGAAATGAAGGTCAGGATAATACACATAATCCTGAATTTACTTCGTGTGAATTTTATTGGGCATATGCT	1091
KRS7AAT	TATGAAATTGGTAAAGTATTTAGAAATGAAGGTAATGATAATACACATAATCCTGAATTTACTTCGTGTGAATTTTATTGGGCATATGCT	1492
KRS7AAC	TATGAAATTGGTAAAGTATTTAGAAATGAAGGTAACGATAATACACATAATCCTGAATTTACTTCGTGTGAATTTTATTGGGCATATGCT	1338
KRS7AAA	TATGAAATTGGTAAAGTATTTAGAAATGAAGGTAAAGATAATACACATAATCCTGAATTTACTTCGTGTGAATTTTATTGGGCATATGCT	2391
KRS7AAG	TATGAAATTGGTAAAGTATTTAGAAATGAAGGTAAGGATAATACACATAATCCTGAATTTACTTCGTGTGAATTTTATTGGGCATATGCT	1016
KRS7GAT	TATGAAATTGGTAAAGTATTTAGAAATGAAGGTGATGATAATACACATAATCCTGAATTTACTTCGTGTGAATTTTATTGGGCATATGCT	612
KRS7GAC	TATGAAATTGGTAAAGTATTTAGAAATGAAGGTGACGATAATACACATAATCCTGAATTTACTTCGTGTGAATTTTATTGGGCATATGCT	455
KRS7GAA	TATGAAATTGGTAAAGTATTTAGAAATGAAGGTGAAGATAATACACATAATCCTGAATTTACTTCGTGTGAATTTTATTGGGCATATGCT	1226
KRS7GAG	TATGAAATTGGTAAAGTATTTAGAAATGAAGGTGAGGATAATACACATAATCCTGAATTTACTTCGTGTGAATTTTATTGGGCATATGCT	332
KRS7TGT	TATGAAATTGGTAAAGTATTTAGAAATGAAGGTTGTGATAATACACATAATCCTGAATTTACTTCGTGTGAATTTTATTGGGCATATGCT	2028
KRS7TGC	TATGAAATTGGTAAAGTATTTAGAAATGAAGGTTGCGATAATACACATAATCCTGAATTTACTTCGTGTGAATTTTATTGGGCATATGCT	574
KRS7TGA	TATGAAATTGGTAAAGTATTTAGAAATGAAGGTTGAGATAATACACATAATCCTGAATTTACTTCGTGTGAATTTTATTGGGCATATGCT	596
KRS7TGG	TATGAAATTGGTAAAGTATTTAGAAATGAAGGTTGGGATAATACACATAATCCTGAATTTACTTCGTGTGAATTTTATTGGGCATATGCT	368
KRS7CGT	TATGAAATTGGTAAAGTATTTAGAAATGAAGGTCGTGATAATACACATAATCCTGAATTTACTTCGTGTGAATTTTATTGGGCATATGCT	425
KRS7CGC	TATGAAATTGGTAAAGTATTTAGAAATGAAGGTCGCGATAATACACATAATCCTGAATTTACTTCGTGTGAATTTTATTGGGCATATGCT	303
KRS7CGA	TATGAAATTGGTAAAGTATTTAGAAATGAAGGTCGAGATAATACACATAATCCTGAATTTACTTCGTGTGAATTTTATTGGGCATATGCT	289
KRS7CGG	TATGAAATTGGTAAAGTATTTAGAAATGAAGGTCGGGATAATACACATAATCCTGAATTTACTTCGTGTGAATTTTATTGGGCATATGCT	146
KRS7AGT	TATGAAATTGGTAAAGTATTTAGAAATGAAGGTAGTGATAATACACATAATCCTGAATTTACTTCGTGTGAATTTTATTGGGCATATGCT	1016
KRS7AGC	TATGAAATTGGTAAAGTATTTAGAAATGAAGGTAGCGATAATACACATAATCCTGAATTTACTTCGTGTGAATTTTATTGGGCATATGCT	616
KRS7AGA	TATGAAATTGGTAAAGTATTTAGAAATGAAGGTAGAGATAATACACATAATCCTGAATTTACTTCGTGTGAATTTTATTGGGCATATGCT	648
KRS7AGG	TATGAAATTGGTAAAGTATTTAGAAATGAAGGTAGGGATAATACACATAATCCTGAATTTACTTCGTGTGAATTTTATTGGGCATATGCT	286
KRS7GGT	TATGAAATTGGTAAAGTATTTAGAAATGAAGGTGGTGATAATACACATAATCCTGAATTTACTTCGTGTGAATTTTATTGGGCATATGCT	323
KRS7GGC	TATGAAATTGGTAAAGTATTTAGAAATGAAGGTGGCGATAATACACATAATCCTGAATTTACTTCGTGTGAATTTTATTGGGCATATGCT	191
KRS7GGA	TATGAAATTGGTAAAGTATTTAGAAATGAAGGTGGAGATAATACACATAATCCTGAATTTACTTCGTGTGAATTTTATTGGGCATATGCT	203
KRS7GGG	TATGAAATTGGTAAAGTATTTAGAAATGAAGGTGGGGATAATACACATAATCCTGAATTTACTTCGTGTGAATTTTATTGGGCATATGCT	148
KRS8TTT	TATGAAATTGGTAAAGTATTTAGAAATGAAGGTATATTTAATACACATAATCCTGAATTTACTTCGTGTGAATTTTATTGGGCATATGCT	6231
KRS8TTC	TATGAAATTGGTAAAGTATTTAGAAATGAAGGTATATTCAATACACATAATCCTGAATTTACTTCGTGTGAATTTTATTGGGCATATGCT	3492
KRS8TTA	TATGAAATTGGTAAAGTATTTAGAAATGAAGGTATATTAAATACACATAATCCTGAATTTACTTCGTGTGAATTTTATTGGGCATATGCT	4804
KRS8TTG	TATGAAATTGGTAAAGTATTTAGAAATGAAGGTATATTGAATACACATAATCCTGAATTTACTTCGTGTGAATTTTATTGGGCATATGCT	1432
KRS8CTT	TATGAAATTGGTAAAGTATTTAGAAATGAAGGTATACTTAATACACATAATCCTGAATTTACTTCGTGTGAATTTTATTGGGCATATGCT	510
KRS8CTC	TATGAAATTGGTAAAGTATTTAGAAATGAAGGTATACTCAATACACATAATCCTGAATTTACTTCGTGTGAATTTTATTGGGCATATGCT	434
KRS8CTA	TATGAAATTGGTAAAGTATTTAGAAATGAAGGTATACTAAATACACATAATCCTGAATTTACTTCGTGTGAATTTTATTGGGCATATGCT	726
KRS8CTG	TATGAAATTGGTAAAGTATTTAGAAATGAAGGTATACTGAATACACATAATCCTGAATTTACTTCGTGTGAATTTTATTGGGCATATGCT	195
KRS8ATT	TATGAAATTGGTAAAGTATTTAGAAATGAAGGTATAATTAATACACATAATCCTGAATTTACTTCGTGTGAATTTTATTGGGCATATGCT	939
KRS8ATC	TATGAAATTGGTAAAGTATTTAGAAATGAAGGTATAATCAATACACATAATCCTGAATTTACTTCGTGTGAATTTTATTGGGCATATGCT	891
KRS8ATA	TATGAAATTGGTAAAGTATTTAGAAATGAAGGTATAATAAATACACATAATCCTGAATTTACTTCGTGTGAATTTTATTGGGCATATGCT	2835
KRS8ATG	TATGAAATTGGTAAAGTATTTAGAAATGAAGGTATAATGAATACACATAATCCTGAATTTACTTCGTGTGAATTTTATTGGGCATATGCT	386
KRS8GTT	TATGAAATTGGTAAAGTATTTAGAAATGAAGGTATAGTTAATACACATAATCCTGAATTTACTTCGTGTGAATTTTATTGGGCATATGCT	1257
KRS8GTC	TATGAAATTGGTAAAGTATTTAGAAATGAAGGTATAGTCAATACACATAATCCTGAATTTACTTCGTGTGAATTTTATTGGGCATATGCT	559
KRS8GTA	TATGAAATTGGTAAAGTATTTAGAAATGAAGGTATAGTAAATACACATAATCCTGAATTTACTTCGTGTGAATTTTATTGGGCATATGCT	1052
KRS8GTG	TATGAAATTGGTAAAGTATTTAGAAATGAAGGTATAGTGAATACACATAATCCTGAATTTACTTCGTGTGAATTTTATTGGGCATATGCT	331
KRS8TCT	TATGAAATTGGTAAAGTATTTAGAAATGAAGGTATATCTAATACACATAATCCTGAATTTACTTCGTGTGAATTTTATTGGGCATATGCT	855
KRS8TCC	TATGAAATTGGTAAAGTATTTAGAAATGAAGGTATATCCAATACACATAATCCTGAATTTACTTCGTGTGAATTTTATTGGGCATATGCT	522
KRS8TCA	TATGAAATTGGTAAAGTATTTAGAAATGAAGGTATATCAAATACACATAATCCTGAATTTACTTCGTGTGAATTTTATTGGGCATATGCT	1139
KRS8TCG	TATGAAATTGGTAAAGTATTTAGAAATGAAGGTATATCGAATACACATAATCCTGAATTTACTTCGTGTGAATTTTATTGGGCATATGCT	122
KRS8CCT	TATGAAATTGGTAAAGTATTTAGAAATGAAGGTATACCTAATACACATAATCCTGAATTTACTTCGTGTGAATTTTATTGGGCATATGCT	117
KRS8CCC	TATGAAATTGGTAAAGTATTTAGAAATGAAGGTATACCCAATACACATAATCCTGAATTTACTTCGTGTGAATTTTATTGGGCATATGCT	71
KRS8CCA	TATGAAATTGGTAAAGTATTTAGAAATGAAGGTATACCAAATACACATAATCCTGAATTTACTTCGTGTGAATTTTATTGGGCATATGCT	278
KRS8CCG	TATGAAATTGGTAAAGTATTTAGAAATGAAGGTATACCGAATACACATAATCCTGAATTTACTTCGTGTGAATTTTATTGGGCATATGCT	34
KRS8ACT	TATGAAATTGGTAAAGTATTTAGAAATGAAGGTATAACTAATACACATAATCCTGAATTTACTTCGTGTGAATTTTATTGGGCATATGCT	306
KRS8ACC	TATGAAATTGGTAAAGTATTTAGAAATGAAGGTATAACCAATACACATAATCCTGAATTTACTTCGTGTGAATTTTATTGGGCATATGCT	238
KRS8ACA	TATGAAATTGGTAAAGTATTTAGAAATGAAGGTATAACAAATACACATAATCCTGAATTTACTTCGTGTGAATTTTATTGGGCATATGCT	1721
KRS8ACG	TATGAAATTGGTAAAGTATTTAGAAATGAAGGTATAACGAATACACATAATCCTGAATTTACTTCGTGTGAATTTTATTGGGCATATGCT	171
KRS8GCT	TATGAAATTGGTAAAGTATTTAGAAATGAAGGTATAGCTAATACACATAATCCTGAATTTACTTCGTGTGAATTTTATTGGGCATATGCT	452
KRS8GCC	TATGAAATTGGTAAAGTATTTAGAAATGAAGGTATAGCCAATACACATAATCCTGAATTTACTTCGTGTGAATTTTATTGGGCATATGCT	139
KRS8GCA	TATGAAATTGGTAAAGTATTTAGAAATGAAGGTATAGCAAATACACATAATCCTGAATTTACTTCGTGTGAATTTTATTGGGCATATGCT	280
KRS8GCG	TATGAAATTGGTAAAGTATTTAGAAATGAAGGTATAGCGAATACACATAATCCTGAATTTACTTCGTGTGAATTTTATTGGGCATATGCT	124
KRS8TAT	TATGAAATTGGTAAAGTATTTAGAAATGAAGGTATATATAATACACATAATCCTGAATTTACTTCGTGTGAATTTTATTGGGCATATGCT	1186
KRS8TAC	TATGAAATTGGTAAAGTATTTAGAAATGAAGGTATATACAATACACATAATCCTGAATTTACTTCGTGTGAATTTTATTGGGCATATGCT	964
KRS8TAA	TATGAAATTGGTAAAGTATTTAGAAATGAAGGTATATAAAATACACATAATCCTGAATTTACTTCGTGTGAATTTTATTGGGCATATGCT	3896
KRS8TAG	TATGAAATTGGTAAAGTATTTAGAAATGAAGGTATATAGAATACACATAATCCTGAATTTACTTCGTGTGAATTTTATTGGGCATATGCT	452
KRS8CAT	TATGAAATTGGTAAAGTATTTAGAAATGAAGGTATACATAATACACATAATCCTGAATTTACTTCGTGTGAATTTTATTGGGCATATGCT	451
KRS8CAC	TATGAAATTGGTAAAGTATTTAGAAATGAAGGTATACACAATACACATAATCCTGAATTTACTTCGTGTGAATTTTATTGGGCATATGCT	406
KRS8CAA	TATGAAATTGGTAAAGTATTTAGAAATGAAGGTATACAAAATACACATAATCCTGAATTTACTTCGTGTGAATTTTATTGGGCATATGCT	2297
KRS8CAG	TATGAAATTGGTAAAGTATTTAGAAATGAAGGTATACAGAATACACATAATCCTGAATTTACTTCGTGTGAATTTTATTGGGCATATGCT	229
KRS8AAT	TATGAAATTGGTAAAGTATTTAGAAATGAAGGTATAAATAATACACATAATCCTGAATTTACTTCGTGTGAATTTTATTGGGCATATGCT	3166
KRS8AAC	TATGAAATTGGTAAAGTATTTAGAAATGAAGGTATAAACAATACACATAATCCTGAATTTACTTCGTGTGAATTTTATTGGGCATATGCT	3069
KRS8AAA	TATGAAATTGGTAAAGTATTTAGAAATGAAGGTATAAAAAATACACATAATCCTGAATTTACTTCGTGTGAATTTTATTGGGCATATGCT	11992
KRS8AAG	TATGAAATTGGTAAAGTATTTAGAAATGAAGGTATAAAGAATACACATAATCCTGAATTTACTTCGTGTGAATTTTATTGGGCATATGCT	943
KRS8GAT	TATGAAATTGGTAAAGTATTTAGAAATGAAGGTATAGATAATACACATAATCCTGAATTTACTTCGTGTGAATTTTATTGGGCATATGCT	53004
KRS8GAC	TATGAAATTGGTAAAGTATTTAGAAATGAAGGTATAGACAATACACATAATCCTGAATTTACTTCGTGTGAATTTTATTGGGCATATGCT	644
KRS8GAA	TATGAAATTGGTAAAGTATTTAGAAATGAAGGTATAGAAAATACACATAATCCTGAATTTACTTCGTGTGAATTTTATTGGGCATATGCT	848
KRS8GAG	TATGAAATTGGTAAAGTATTTAGAAATGAAGGTATAGAGAATACACATAATCCTGAATTTACTTCGTGTGAATTTTATTGGGCATATGCT	134
KRS8TGT	TATGAAATTGGTAAAGTATTTAGAAATGAAGGTATATGTAATACACATAATCCTGAATTTACTTCGTGTGAATTTTATTGGGCATATGCT	1630
KRS8TGC	TATGAAATTGGTAAAGTATTTAGAAATGAAGGTATATGCAATACACATAATCCTGAATTTACTTCGTGTGAATTTTATTGGGCATATGCT	535
KRS8TGA	TATGAAATTGGTAAAGTATTTAGAAATGAAGGTATATGAAATACACATAATCCTGAATTTACTTCGTGTGAATTTTATTGGGCATATGCT	902
KRS8TGG	TATGAAATTGGTAAAGTATTTAGAAATGAAGGTATATGGAATACACATAATCCTGAATTTACTTCGTGTGAATTTTATTGGGCATATGCT	148
KRS8CGT	TATGAAATTGGTAAAGTATTTAGAAATGAAGGTATACGTAATACACATAATCCTGAATTTACTTCGTGTGAATTTTATTGGGCATATGCT	86
KRS8CGC	TATGAAATTGGTAAAGTATTTAGAAATGAAGGTATACGCAATACACATAATCCTGAATTTACTTCGTGTGAATTTTATTGGGCATATGCT	47
KRS8CGA	TATGAAATTGGTAAAGTATTTAGAAATGAAGGTATACGAAATACACATAATCCTGAATTTACTTCGTGTGAATTTTATTGGGCATATGCT	154
KRS8CGG	TATGAAATTGGTAAAGTATTTAGAAATGAAGGTATACGGAATACACATAATCCTGAATTTACTTCGTGTGAATTTTATTGGGCATATGCT	21
KRS8AGT	TATGAAATTGGTAAAGTATTTAGAAATGAAGGTATAAGTAATACACATAATCCTGAATTTACTTCGTGTGAATTTTATTGGGCATATGCT	333
KRS8AGC	TATGAAATTGGTAAAGTATTTAGAAATGAAGGTATAAGCAATACACATAATCCTGAATTTACTTCGTGTGAATTTTATTGGGCATATGCT	318
KRS8AGA	TATGAAATTGGTAAAGTATTTAGAAATGAAGGTATAAGAAATACACATAATCCTGAATTTACTTCGTGTGAATTTTATTGGGCATATGCT	977
KRS8AGG	TATGAAATTGGTAAAGTATTTAGAAATGAAGGTATAAGGAATACACATAATCCTGAATTTACTTCGTGTGAATTTTATTGGGCATATGCT	75
KRS8GGT	TATGAAATTGGTAAAGTATTTAGAAATGAAGGTATAGGTAATACACATAATCCTGAATTTACTTCGTGTGAATTTTATTGGGCATATGCT	242
KRS8GGC	TATGAAATTGGTAAAGTATTTAGAAATGAAGGTATAGGCAATACACATAATCCTGAATTTACTTCGTGTGAATTTTATTGGGCATATGCT	68
KRS8GGA	TATGAAATTGGTAAAGTATTTAGAAATGAAGGTATAGGAAATACACATAATCCTGAATTTACTTCGTGTGAATTTTATTGGGCATATGCT	104
KRS8GGG	TATGAAATTGGTAAAGTATTTAGAAATGAAGGTATAGGGAATACACATAATCCTGAATTTACTTCGTGTGAATTTTATTGGGCATATGCT	16
KRS9TTT	TATGAAATTGGTAAAGTATTTAGAAATGAAGGTATAGATTTTACACATAATCCTGAATTTACTTCGTGTGAATTTTATTGGGCATATGCT	25730
KRS9TTC	TATGAAATTGGTAAAGTATTTAGAAATGAAGGTATAGATTTCACACATAATCCTGAATTTACTTCGTGTGAATTTTATTGGGCATATGCT	4976
KRS9TTA	TATGAAATTGGTAAAGTATTTAGAAATGAAGGTATAGATTTAACACATAATCCTGAATTTACTTCGTGTGAATTTTATTGGGCATATGCT	6539
KRS9TTG	TATGAAATTGGTAAAGTATTTAGAAATGAAGGTATAGATTTGACACATAATCCTGAATTTACTTCGTGTGAATTTTATTGGGCATATGCT	2808
KRS9CTT	TATGAAATTGGTAAAGTATTTAGAAATGAAGGTATAGATCTTACACATAATCCTGAATTTACTTCGTGTGAATTTTATTGGGCATATGCT	5602
KRS9CTC	TATGAAATTGGTAAAGTATTTAGAAATGAAGGTATAGATCTCACACATAATCCTGAATTTACTTCGTGTGAATTTTATTGGGCATATGCT	979
KRS9CTA	TATGAAATTGGTAAAGTATTTAGAAATGAAGGTATAGATCTAACACATAATCCTGAATTTACTTCGTGTGAATTTTATTGGGCATATGCT	6358
KRS9CTG	TATGAAATTGGTAAAGTATTTAGAAATGAAGGTATAGATCTGACACATAATCCTGAATTTACTTCGTGTGAATTTTATTGGGCATATGCT	549
KRS9ATT	TATGAAATTGGTAAAGTATTTAGAAATGAAGGTATAGATATTACACATAATCCTGAATTTACTTCGTGTGAATTTTATTGGGCATATGCT	5363
KRS9ATC	TATGAAATTGGTAAAGTATTTAGAAATGAAGGTATAGATATCACACATAATCCTGAATTTACTTCGTGTGAATTTTATTGGGCATATGCT	2269
KRS9ATA	TATGAAATTGGTAAAGTATTTAGAAATGAAGGTATAGATATAACACATAATCCTGAATTTACTTCGTGTGAATTTTATTGGGCATATGCT	8913
KRS9ATG	TATGAAATTGGTAAAGTATTTAGAAATGAAGGTATAGATATGACACATAATCCTGAATTTACTTCGTGTGAATTTTATTGGGCATATGCT	960
KRS9GTT	TATGAAATTGGTAAAGTATTTAGAAATGAAGGTATAGATGTTACACATAATCCTGAATTTACTTCGTGTGAATTTTATTGGGCATATGCT	2884
KRS9GTC	TATGAAATTGGTAAAGTATTTAGAAATGAAGGTATAGATGTCACACATAATCCTGAATTTACTTCGTGTGAATTTTATTGGGCATATGCT	781
KRS9GTA	TATGAAATTGGTAAAGTATTTAGAAATGAAGGTATAGATGTAACACATAATCCTGAATTTACTTCGTGTGAATTTTATTGGGCATATGCT	1075
KRS9GTG	TATGAAATTGGTAAAGTATTTAGAAATGAAGGTATAGATGTGACACATAATCCTGAATTTACTTCGTGTGAATTTTATTGGGCATATGCT	526
KRS9TCT	TATGAAATTGGTAAAGTATTTAGAAATGAAGGTATAGATTCTACACATAATCCTGAATTTACTTCGTGTGAATTTTATTGGGCATATGCT	4328
KRS9TCC	TATGAAATTGGTAAAGTATTTAGAAATGAAGGTATAGATTCCACACATAATCCTGAATTTACTTCGTGTGAATTTTATTGGGCATATGCT	1119
KRS9TCA	TATGAAATTGGTAAAGTATTTAGAAATGAAGGTATAGATTCAACACATAATCCTGAATTTACTTCGTGTGAATTTTATTGGGCATATGCT	3089
KRS9TCG	TATGAAATTGGTAAAGTATTTAGAAATGAAGGTATAGATTCGACACATAATCCTGAATTTACTTCGTGTGAATTTTATTGGGCATATGCT	404
KRS9CCT	TATGAAATTGGTAAAGTATTTAGAAATGAAGGTATAGATCCTACACATAATCCTGAATTTACTTCGTGTGAATTTTATTGGGCATATGCT	1692
KRS9CCC	TATGAAATTGGTAAAGTATTTAGAAATGAAGGTATAGATCCCACACATAATCCTGAATTTACTTCGTGTGAATTTTATTGGGCATATGCT	275
KRS9CCA	TATGAAATTGGTAAAGTATTTAGAAATGAAGGTATAGATCCAACACATAATCCTGAATTTACTTCGTGTGAATTTTATTGGGCATATGCT	923
KRS9CCG	TATGAAATTGGTAAAGTATTTAGAAATGAAGGTATAGATCCGACACATAATCCTGAATTTACTTCGTGTGAATTTTATTGGGCATATGCT	93
KRS9ACT	TATGAAATTGGTAAAGTATTTAGAAATGAAGGTATAGATACTACACATAATCCTGAATTTACTTCGTGTGAATTTTATTGGGCATATGCT	1832
KRS9ACC	TATGAAATTGGTAAAGTATTTAGAAATGAAGGTATAGATACCACACATAATCCTGAATTTACTTCGTGTGAATTTTATTGGGCATATGCT	1227
KRS9ACA	TATGAAATTGGTAAAGTATTTAGAAATGAAGGTATAGATACAACACATAATCCTGAATTTACTTCGTGTGAATTTTATTGGGCATATGCT	9503
KRS9ACG	TATGAAATTGGTAAAGTATTTAGAAATGAAGGTATAGATACGACACATAATCCTGAATTTACTTCGTGTGAATTTTATTGGGCATATGCT	386
KRS9GCT	TATGAAATTGGTAAAGTATTTAGAAATGAAGGTATAGATGCTACACATAATCCTGAATTTACTTCGTGTGAATTTTATTGGGCATATGCT	788
KRS9GCC	TATGAAATTGGTAAAGTATTTAGAAATGAAGGTATAGATGCCACACATAATCCTGAATTTACTTCGTGTGAATTTTATTGGGCATATGCT	232
KRS9GCA	TATGAAATTGGTAAAGTATTTAGAAATGAAGGTATAGATGCAACACATAATCCTGAATTTACTTCGTGTGAATTTTATTGGGCATATGCT	916
KRS9GCG	TATGAAATTGGTAAAGTATTTAGAAATGAAGGTATAGATGCGACACATAATCCTGAATTTACTTCGTGTGAATTTTATTGGGCATATGCT	101
KRS9TAT	TATGAAATTGGTAAAGTATTTAGAAATGAAGGTATAGATTATACACATAATCCTGAATTTACTTCGTGTGAATTTTATTGGGCATATGCT	6041
KRS9TAC	TATGAAATTGGTAAAGTATTTAGAAATGAAGGTATAGATTACACACATAATCCTGAATTTACTTCGTGTGAATTTTATTGGGCATATGCT	2239
KRS9TAA	TATGAAATTGGTAAAGTATTTAGAAATGAAGGTATAGATTAAACACATAATCCTGAATTTACTTCGTGTGAATTTTATTGGGCATATGCT	11879
KRS9TAG	TATGAAATTGGTAAAGTATTTAGAAATGAAGGTATAGATTAGACACATAATCCTGAATTTACTTCGTGTGAATTTTATTGGGCATATGCT	1094
KRS9CAT	TATGAAATTGGTAAAGTATTTAGAAATGAAGGTATAGATCATACACATAATCCTGAATTTACTTCGTGTGAATTTTATTGGGCATATGCT	1673
KRS9CAC	TATGAAATTGGTAAAGTATTTAGAAATGAAGGTATAGATCACACACATAATCCTGAATTTACTTCGTGTGAATTTTATTGGGCATATGCT	2031
KRS9CAA	TATGAAATTGGTAAAGTATTTAGAAATGAAGGTATAGATCAAACACATAATCCTGAATTTACTTCGTGTGAATTTTATTGGGCATATGCT	4133
KRS9CAG	TATGAAATTGGTAAAGTATTTAGAAATGAAGGTATAGATCAGACACATAATCCTGAATTTACTTCGTGTGAATTTTATTGGGCATATGCT	299
KRS9AAT	TATGAAATTGGTAAAGTATTTAGAAATGAAGGTATAGATAATACACATAATCCTGAATTTACTTCGTGTGAATTTTATTGGGCATATGCT	53004
KRS9AAC	TATGAAATTGGTAAAGTATTTAGAAATGAAGGTATAGATAACACACATAATCCTGAATTTACTTCGTGTGAATTTTATTGGGCATATGCT	5787
KRS9AAA	TATGAAATTGGTAAAGTATTTAGAAATGAAGGTATAGATAAAACACATAATCCTGAATTTACTTCGTGTGAATTTTATTGGGCATATGCT	39901
KRS9AAG	TATGAAATTGGTAAAGTATTTAGAAATGAAGGTATAGATAAGACACATAATCCTGAATTTACTTCGTGTGAATTTTATTGGGCATATGCT	2148
KRS9GAT	TATGAAATTGGTAAAGTATTTAGAAATGAAGGTATAGATGATACACATAATCCTGAATTTACTTCGTGTGAATTTTATTGGGCATATGCT	1031
KRS9GAC	TATGAAATTGGTAAAGTATTTAGAAATGAAGGTATAGATGACACACATAATCCTGAATTTACTTCGTGTGAATTTTATTGGGCATATGCT	482
KRS9GAA	TATGAAATTGGTAAAGTATTTAGAAATGAAGGTATAGATGAAACACATAATCCTGAATTTACTTCGTGTGAATTTTATTGGGCATATGCT	2312
KRS9GAG	TATGAAATTGGTAAAGTATTTAGAAATGAAGGTATAGATGAGACACATAATCCTGAATTTACTTCGTGTGAATTTTATTGGGCATATGCT	221
KRS9TGT	TATGAAATTGGTAAAGTATTTAGAAATGAAGGTATAGATTGTACACATAATCCTGAATTTACTTCGTGTGAATTTTATTGGGCATATGCT	4979
KRS9TGC	TATGAAATTGGTAAAGTATTTAGAAATGAAGGTATAGATTGCACACATAATCCTGAATTTACTTCGTGTGAATTTTATTGGGCATATGCT	1462
KRS9TGA	TATGAAATTGGTAAAGTATTTAGAAATGAAGGTATAGATTGAACACATAATCCTGAATTTACTTCGTGTGAATTTTATTGGGCATATGCT	1805
KRS9TGG	TATGAAATTGGTAAAGTATTTAGAAATGAAGGTATAGATTGGACACATAATCCTGAATTTACTTCGTGTGAATTTTATTGGGCATATGCT	468
KRS9CGT	TATGAAATTGGTAAAGTATTTAGAAATGAAGGTATAGATCGTACACATAATCCTGAATTTACTTCGTGTGAATTTTATTGGGCATATGCT	642
KRS9CGC	TATGAAATTGGTAAAGTATTTAGAAATGAAGGTATAGATCGCACACATAATCCTGAATTTACTTCGTGTGAATTTTATTGGGCATATGCT	345
KRS9CGA	TATGAAATTGGTAAAGTATTTAGAAATGAAGGTATAGATCGAACACATAATCCTGAATTTACTTCGTGTGAATTTTATTGGGCATATGCT	393
KRS9CGG	TATGAAATTGGTAAAGTATTTAGAAATGAAGGTATAGATCGGACACATAATCCTGAATTTACTTCGTGTGAATTTTATTGGGCATATGCT	84
KRS9AGT	TATGAAATTGGTAAAGTATTTAGAAATGAAGGTATAGATAGTACACATAATCCTGAATTTACTTCGTGTGAATTTTATTGGGCATATGCT	1219
KRS9AGC	TATGAAATTGGTAAAGTATTTAGAAATGAAGGTATAGATAGCACACATAATCCTGAATTTACTTCGTGTGAATTTTATTGGGCATATGCT	646
KRS9AGA	TATGAAATTGGTAAAGTATTTAGAAATGAAGGTATAGATAGAACACATAATCCTGAATTTACTTCGTGTGAATTTTATTGGGCATATGCT	3052
KRS9AGG	TATGAAATTGGTAAAGTATTTAGAAATGAAGGTATAGATAGGACACATAATCCTGAATTTACTTCGTGTGAATTTTATTGGGCATATGCT	263
KRS9GGT	TATGAAATTGGTAAAGTATTTAGAAATGAAGGTATAGATGGTACACATAATCCTGAATTTACTTCGTGTGAATTTTATTGGGCATATGCT	455
KRS9GGC	TATGAAATTGGTAAAGTATTTAGAAATGAAGGTATAGATGGCACACATAATCCTGAATTTACTTCGTGTGAATTTTATTGGGCATATGCT	130
KRS9GGA	TATGAAATTGGTAAAGTATTTAGAAATGAAGGTATAGATGGAACACATAATCCTGAATTTACTTCGTGTGAATTTTATTGGGCATATGCT	293
KRS9GGG	TATGAAATTGGTAAAGTATTTAGAAATGAAGGTATAGATGGGACACATAATCCTGAATTTACTTCGTGTGAATTTTATTGGGCATATGCT	56
KRS10TTT	TATGAAATTGGTAAAGTATTTAGAAATGAAGGTATAGATAATTTTCATAATCCTGAATTTACTTCGTGTGAATTTTATTGGGCATATGCT	7047
KRS10TTC	TATGAAATTGGTAAAGTATTTAGAAATGAAGGTATAGATAATTTCCATAATCCTGAATTTACTTCGTGTGAATTTTATTGGGCATATGCT	2019
KRS10TTA	TATGAAATTGGTAAAGTATTTAGAAATGAAGGTATAGATAATTTACATAATCCTGAATTTACTTCGTGTGAATTTTATTGGGCATATGCT	7018
KRS10TTG	TATGAAATTGGTAAAGTATTTAGAAATGAAGGTATAGATAATTTGCATAATCCTGAATTTACTTCGTGTGAATTTTATTGGGCATATGCT	3122
KRS10CTT	TATGAAATTGGTAAAGTATTTAGAAATGAAGGTATAGATAATCTTCATAATCCTGAATTTACTTCGTGTGAATTTTATTGGGCATATGCT	1378
KRS10CTC	TATGAAATTGGTAAAGTATTTAGAAATGAAGGTATAGATAATCTCCATAATCCTGAATTTACTTCGTGTGAATTTTATTGGGCATATGCT	604
KRS10CTA	TATGAAATTGGTAAAGTATTTAGAAATGAAGGTATAGATAATCTACATAATCCTGAATTTACTTCGTGTGAATTTTATTGGGCATATGCT	920
KRS10CTG	TATGAAATTGGTAAAGTATTTAGAAATGAAGGTATAGATAATCTGCATAATCCTGAATTTACTTCGTGTGAATTTTATTGGGCATATGCT	792
KRS10ATT	TATGAAATTGGTAAAGTATTTAGAAATGAAGGTATAGATAATATTCATAATCCTGAATTTACTTCGTGTGAATTTTATTGGGCATATGCT	3514
KRS10ATC	TATGAAATTGGTAAAGTATTTAGAAATGAAGGTATAGATAATATCCATAATCCTGAATTTACTTCGTGTGAATTTTATTGGGCATATGCT	3092
KRS10ATA	TATGAAATTGGTAAAGTATTTAGAAATGAAGGTATAGATAATATACATAATCCTGAATTTACTTCGTGTGAATTTTATTGGGCATATGCT	10358
KRS10ATG	TATGAAATTGGTAAAGTATTTAGAAATGAAGGTATAGATAATATGCATAATCCTGAATTTACTTCGTGTGAATTTTATTGGGCATATGCT	1423
KRS10GTT	TATGAAATTGGTAAAGTATTTAGAAATGAAGGTATAGATAATGTTCATAATCCTGAATTTACTTCGTGTGAATTTTATTGGGCATATGCT	2108
KRS10GTC	TATGAAATTGGTAAAGTATTTAGAAATGAAGGTATAGATAATGTCCATAATCCTGAATTTACTTCGTGTGAATTTTATTGGGCATATGCT	756
KRS10GTA	TATGAAATTGGTAAAGTATTTAGAAATGAAGGTATAGATAATGTACATAATCCTGAATTTACTTCGTGTGAATTTTATTGGGCATATGCT	1762
KRS10GTG	TATGAAATTGGTAAAGTATTTAGAAATGAAGGTATAGATAATGTGCATAATCCTGAATTTACTTCGTGTGAATTTTATTGGGCATATGCT	1938
KRS10TCT	TATGAAATTGGTAAAGTATTTAGAAATGAAGGTATAGATAATTCTCATAATCCTGAATTTACTTCGTGTGAATTTTATTGGGCATATGCT	1702
KRS10TCC	TATGAAATTGGTAAAGTATTTAGAAATGAAGGTATAGATAATTCCCATAATCCTGAATTTACTTCGTGTGAATTTTATTGGGCATATGCT	949
KRS10TCA	TATGAAATTGGTAAAGTATTTAGAAATGAAGGTATAGATAATTCACATAATCCTGAATTTACTTCGTGTGAATTTTATTGGGCATATGCT	1347
KRS10TCG	TATGAAATTGGTAAAGTATTTAGAAATGAAGGTATAGATAATTCGCATAATCCTGAATTTACTTCGTGTGAATTTTATTGGGCATATGCT	698
KRS10CCT	TATGAAATTGGTAAAGTATTTAGAAATGAAGGTATAGATAATCCTCATAATCCTGAATTTACTTCGTGTGAATTTTATTGGGCATATGCT	258
KRS10CCC	TATGAAATTGGTAAAGTATTTAGAAATGAAGGTATAGATAATCCCCATAATCCTGAATTTACTTCGTGTGAATTTTATTGGGCATATGCT	144
KRS10CCA	TATGAAATTGGTAAAGTATTTAGAAATGAAGGTATAGATAATCCACATAATCCTGAATTTACTTCGTGTGAATTTTATTGGGCATATGCT	392
KRS10CCG	TATGAAATTGGTAAAGTATTTAGAAATGAAGGTATAGATAATCCGCATAATCCTGAATTTACTTCGTGTGAATTTTATTGGGCATATGCT	231
KRS10ACT	TATGAAATTGGTAAAGTATTTAGAAATGAAGGTATAGATAATACTCATAATCCTGAATTTACTTCGTGTGAATTTTATTGGGCATATGCT	1318
KRS10ACC	TATGAAATTGGTAAAGTATTTAGAAATGAAGGTATAGATAATACCCATAATCCTGAATTTACTTCGTGTGAATTTTATTGGGCATATGCT	739
KRS10ACA	TATGAAATTGGTAAAGTATTTAGAAATGAAGGTATAGATAATACACATAATCCTGAATTTACTTCGTGTGAATTTTATTGGGCATATGCT	53004
KRS10ACG	TATGAAATTGGTAAAGTATTTAGAAATGAAGGTATAGATAATACGCATAATCCTGAATTTACTTCGTGTGAATTTTATTGGGCATATGCT	556
KRS10GCT	TATGAAATTGGTAAAGTATTTAGAAATGAAGGTATAGATAATGCTCATAATCCTGAATTTACTTCGTGTGAATTTTATTGGGCATATGCT	689
KRS10GCC	TATGAAATTGGTAAAGTATTTAGAAATGAAGGTATAGATAATGCCCATAATCCTGAATTTACTTCGTGTGAATTTTATTGGGCATATGCT	238
KRS10GCA	TATGAAATTGGTAAAGTATTTAGAAATGAAGGTATAGATAATGCACATAATCCTGAATTTACTTCGTGTGAATTTTATTGGGCATATGCT	719
KRS10GCG	TATGAAATTGGTAAAGTATTTAGAAATGAAGGTATAGATAATGCGCATAATCCTGAATTTACTTCGTGTGAATTTTATTGGGCATATGCT	616
KRS10TAT	TATGAAATTGGTAAAGTATTTAGAAATGAAGGTATAGATAATTATCATAATCCTGAATTTACTTCGTGTGAATTTTATTGGGCATATGCT	6045
KRS10TAC	TATGAAATTGGTAAAGTATTTAGAAATGAAGGTATAGATAATTACCATAATCCTGAATTTACTTCGTGTGAATTTTATTGGGCATATGCT	3636
KRS10TAA	TATGAAATTGGTAAAGTATTTAGAAATGAAGGTATAGATAATTAACATAATCCTGAATTTACTTCGTGTGAATTTTATTGGGCATATGCT	7290
KRS10TAG	TATGAAATTGGTAAAGTATTTAGAAATGAAGGTATAGATAATTAGCATAATCCTGAATTTACTTCGTGTGAATTTTATTGGGCATATGCT	1296
KRS10CAT	TATGAAATTGGTAAAGTATTTAGAAATGAAGGTATAGATAATCATCATAATCCTGAATTTACTTCGTGTGAATTTTATTGGGCATATGCT	1171
KRS10CAC	TATGAAATTGGTAAAGTATTTAGAAATGAAGGTATAGATAATCACCATAATCCTGAATTTACTTCGTGTGAATTTTATTGGGCATATGCT	848
KRS10CAA	TATGAAATTGGTAAAGTATTTAGAAATGAAGGTATAGATAATCAACATAATCCTGAATTTACTTCGTGTGAATTTTATTGGGCATATGCT	2232
KRS10CAG	TATGAAATTGGTAAAGTATTTAGAAATGAAGGTATAGATAATCAGCATAATCCTGAATTTACTTCGTGTGAATTTTATTGGGCATATGCT	476
KRS10AAT	TATGAAATTGGTAAAGTATTTAGAAATGAAGGTATAGATAATAATCATAATCCTGAATTTACTTCGTGTGAATTTTATTGGGCATATGCT	8541
KRS10AAC	TATGAAATTGGTAAAGTATTTAGAAATGAAGGTATAGATAATAACCATAATCCTGAATTTACTTCGTGTGAATTTTATTGGGCATATGCT	11129
KRS10AAA	TATGAAATTGGTAAAGTATTTAGAAATGAAGGTATAGATAATAAACATAATCCTGAATTTACTTCGTGTGAATTTTATTGGGCATATGCT	28870
KRS10AAG	TATGAAATTGGTAAAGTATTTAGAAATGAAGGTATAGATAATAAGCATAATCCTGAATTTACTTCGTGTGAATTTTATTGGGCATATGCT	3266
KRS10GAT	TATGAAATTGGTAAAGTATTTAGAAATGAAGGTATAGATAATGATCATAATCCTGAATTTACTTCGTGTGAATTTTATTGGGCATATGCT	1856
KRS10GAC	TATGAAATTGGTAAAGTATTTAGAAATGAAGGTATAGATAATGACCATAATCCTGAATTTACTTCGTGTGAATTTTATTGGGCATATGCT	1110
KRS10GAA	TATGAAATTGGTAAAGTATTTAGAAATGAAGGTATAGATAATGAACATAATCCTGAATTTACTTCGTGTGAATTTTATTGGGCATATGCT	2524
KRS10GAG	TATGAAATTGGTAAAGTATTTAGAAATGAAGGTATAGATAATGAGCATAATCCTGAATTTACTTCGTGTGAATTTTATTGGGCATATGCT	655
KRS10TGT	TATGAAATTGGTAAAGTATTTAGAAATGAAGGTATAGATAATTGTCATAATCCTGAATTTACTTCGTGTGAATTTTATTGGGCATATGCT	3159
KRS10TGC	TATGAAATTGGTAAAGTATTTAGAAATGAAGGTATAGATAATTGCCATAATCCTGAATTTACTTCGTGTGAATTTTATTGGGCATATGCT	927
KRS10TGA	TATGAAATTGGTAAAGTATTTAGAAATGAAGGTATAGATAATTGACATAATCCTGAATTTACTTCGTGTGAATTTTATTGGGCATATGCT	1489
KRS10TGG	TATGAAATTGGTAAAGTATTTAGAAATGAAGGTATAGATAATTGGCATAATCCTGAATTTACTTCGTGTGAATTTTATTGGGCATATGCT	1444
KRS10CGT	TATGAAATTGGTAAAGTATTTAGAAATGAAGGTATAGATAATCGTCATAATCCTGAATTTACTTCGTGTGAATTTTATTGGGCATATGCT	453
KRS10CGC	TATGAAATTGGTAAAGTATTTAGAAATGAAGGTATAGATAATCGCCATAATCCTGAATTTACTTCGTGTGAATTTTATTGGGCATATGCT	224
KRS10CGA	TATGAAATTGGTAAAGTATTTAGAAATGAAGGTATAGATAATCGACATAATCCTGAATTTACTTCGTGTGAATTTTATTGGGCATATGCT	272
KRS10CGG	TATGAAATTGGTAAAGTATTTAGAAATGAAGGTATAGATAATCGGCATAATCCTGAATTTACTTCGTGTGAATTTTATTGGGCATATGCT	198
KRS10AGT	TATGAAATTGGTAAAGTATTTAGAAATGAAGGTATAGATAATAGTCATAATCCTGAATTTACTTCGTGTGAATTTTATTGGGCATATGCT	830
KRS10AGC	TATGAAATTGGTAAAGTATTTAGAAATGAAGGTATAGATAATAGCCATAATCCTGAATTTACTTCGTGTGAATTTTATTGGGCATATGCT	528
KRS10AGA	TATGAAATTGGTAAAGTATTTAGAAATGAAGGTATAGATAATAGACATAATCCTGAATTTACTTCGTGTGAATTTTATTGGGCATATGCT	867
KRS10AGG	TATGAAATTGGTAAAGTATTTAGAAATGAAGGTATAGATAATAGGCATAATCCTGAATTTACTTCGTGTGAATTTTATTGGGCATATGCT	337
KRS10GGT	TATGAAATTGGTAAAGTATTTAGAAATGAAGGTATAGATAATGGTCATAATCCTGAATTTACTTCGTGTGAATTTTATTGGGCATATGCT	1368
KRS10GGC	TATGAAATTGGTAAAGTATTTAGAAATGAAGGTATAGATAATGGCCATAATCCTGAATTTACTTCGTGTGAATTTTATTGGGCATATGCT	332
KRS10GGA	TATGAAATTGGTAAAGTATTTAGAAATGAAGGTATAGATAATGGACATAATCCTGAATTTACTTCGTGTGAATTTTATTGGGCATATGCT	617
KRS10GGG	TATGAAATTGGTAAAGTATTTAGAAATGAAGGTATAGATAATGGGCATAATCCTGAATTTACTTCGTGTGAATTTTATTGGGCATATGCT	443
KRS11TTT	TATGAAATTGGTAAAGTATTTAGAAATGAAGGTATAGATAATACATTTAATCCTGAATTTACTTCGTGTGAATTTTATTGGGCATATGCT	2492
KRS11TTC	TATGAAATTGGTAAAGTATTTAGAAATGAAGGTATAGATAATACATTCAATCCTGAATTTACTTCGTGTGAATTTTATTGGGCATATGCT	351
KRS11TTA	TATGAAATTGGTAAAGTATTTAGAAATGAAGGTATAGATAATACATTAAATCCTGAATTTACTTCGTGTGAATTTTATTGGGCATATGCT	2999
KRS11TTG	TATGAAATTGGTAAAGTATTTAGAAATGAAGGTATAGATAATACATTGAATCCTGAATTTACTTCGTGTGAATTTTATTGGGCATATGCT	807
KRS11CTT	TATGAAATTGGTAAAGTATTTAGAAATGAAGGTATAGATAATACACTTAATCCTGAATTTACTTCGTGTGAATTTTATTGGGCATATGCT	328
KRS11CTC	TATGAAATTGGTAAAGTATTTAGAAATGAAGGTATAGATAATACACTCAATCCTGAATTTACTTCGTGTGAATTTTATTGGGCATATGCT	159
KRS11CTA	TATGAAATTGGTAAAGTATTTAGAAATGAAGGTATAGATAATACACTAAATCCTGAATTTACTTCGTGTGAATTTTATTGGGCATATGCT	282
KRS11CTG	TATGAAATTGGTAAAGTATTTAGAAATGAAGGTATAGATAATACACTGAATCCTGAATTTACTTCGTGTGAATTTTATTGGGCATATGCT	528
KRS11ATT	TATGAAATTGGTAAAGTATTTAGAAATGAAGGTATAGATAATACAATTAATCCTGAATTTACTTCGTGTGAATTTTATTGGGCATATGCT	615
KRS11ATC	TATGAAATTGGTAAAGTATTTAGAAATGAAGGTATAGATAATACAATCAATCCTGAATTTACTTCGTGTGAATTTTATTGGGCATATGCT	304
KRS11ATA	TATGAAATTGGTAAAGTATTTAGAAATGAAGGTATAGATAATACAATAAATCCTGAATTTACTTCGTGTGAATTTTATTGGGCATATGCT	2511
KRS11ATG	TATGAAATTGGTAAAGTATTTAGAAATGAAGGTATAGATAATACAATGAATCCTGAATTTACTTCGTGTGAATTTTATTGGGCATATGCT	291
KRS11GTT	TATGAAATTGGTAAAGTATTTAGAAATGAAGGTATAGATAATACAGTTAATCCTGAATTTACTTCGTGTGAATTTTATTGGGCATATGCT	396
KRS11GTC	TATGAAATTGGTAAAGTATTTAGAAATGAAGGTATAGATAATACAGTCAATCCTGAATTTACTTCGTGTGAATTTTATTGGGCATATGCT	7434
KRS11GTA	TATGAAATTGGTAAAGTATTTAGAAATGAAGGTATAGATAATACAGTAAATCCTGAATTTACTTCGTGTGAATTTTATTGGGCATATGCT	738
KRS11GTG	TATGAAATTGGTAAAGTATTTAGAAATGAAGGTATAGATAATACAGTGAATCCTGAATTTACTTCGTGTGAATTTTATTGGGCATATGCT	227
KRS11TCT	TATGAAATTGGTAAAGTATTTAGAAATGAAGGTATAGATAATACATCTAATCCTGAATTTACTTCGTGTGAATTTTATTGGGCATATGCT	362
KRS11TCC	TATGAAATTGGTAAAGTATTTAGAAATGAAGGTATAGATAATACATCCAATCCTGAATTTACTTCGTGTGAATTTTATTGGGCATATGCT	407
KRS11TCA	TATGAAATTGGTAAAGTATTTAGAAATGAAGGTATAGATAATACATCAAATCCTGAATTTACTTCGTGTGAATTTTATTGGGCATATGCT	622
KRS11TCG	TATGAAATTGGTAAAGTATTTAGAAATGAAGGTATAGATAATACATCGAATCCTGAATTTACTTCGTGTGAATTTTATTGGGCATATGCT	57
KRS11CCT	TATGAAATTGGTAAAGTATTTAGAAATGAAGGTATAGATAATACACCTAATCCTGAATTTACTTCGTGTGAATTTTATTGGGCATATGCT	450
KRS11CCC	TATGAAATTGGTAAAGTATTTAGAAATGAAGGTATAGATAATACACCCAATCCTGAATTTACTTCGTGTGAATTTTATTGGGCATATGCT	23
KRS11CCA	TATGAAATTGGTAAAGTATTTAGAAATGAAGGTATAGATAATACACCAAATCCTGAATTTACTTCGTGTGAATTTTATTGGGCATATGCT	203
KRS11CCG	TATGAAATTGGTAAAGTATTTAGAAATGAAGGTATAGATAATACACCGAATCCTGAATTTACTTCGTGTGAATTTTATTGGGCATATGCT	15
KRS11ACT	TATGAAATTGGTAAAGTATTTAGAAATGAAGGTATAGATAATACAACTAATCCTGAATTTACTTCGTGTGAATTTTATTGGGCATATGCT	917
KRS11ACC	TATGAAATTGGTAAAGTATTTAGAAATGAAGGTATAGATAATACAACCAATCCTGAATTTACTTCGTGTGAATTTTATTGGGCATATGCT	106
KRS11ACA	TATGAAATTGGTAAAGTATTTAGAAATGAAGGTATAGATAATACAACAAATCCTGAATTTACTTCGTGTGAATTTTATTGGGCATATGCT	1904
KRS11ACG	TATGAAATTGGTAAAGTATTTAGAAATGAAGGTATAGATAATACAACGAATCCTGAATTTACTTCGTGTGAATTTTATTGGGCATATGCT	40
KRS11GCT	TATGAAATTGGTAAAGTATTTAGAAATGAAGGTATAGATAATACAGCTAATCCTGAATTTACTTCGTGTGAATTTTATTGGGCATATGCT	86
KRS11GCC	TATGAAATTGGTAAAGTATTTAGAAATGAAGGTATAGATAATACAGCCAATCCTGAATTTACTTCGTGTGAATTTTATTGGGCATATGCT	93
KRS11GCA	TATGAAATTGGTAAAGTATTTAGAAATGAAGGTATAGATAATACAGCAAATCCTGAATTTACTTCGTGTGAATTTTATTGGGCATATGCT	155
KRS11GCG	TATGAAATTGGTAAAGTATTTAGAAATGAAGGTATAGATAATACAGCGAATCCTGAATTTACTTCGTGTGAATTTTATTGGGCATATGCT	27
KRS11TAT	TATGAAATTGGTAAAGTATTTAGAAATGAAGGTATAGATAATACATATAATCCTGAATTTACTTCGTGTGAATTTTATTGGGCATATGCT	446
KRS11TAC	TATGAAATTGGTAAAGTATTTAGAAATGAAGGTATAGATAATACATACAATCCTGAATTTACTTCGTGTGAATTTTATTGGGCATATGCT	188
KRS11TAA	TATGAAATTGGTAAAGTATTTAGAAATGAAGGTATAGATAATACATAAAATCCTGAATTTACTTCGTGTGAATTTTATTGGGCATATGCT	3579
KRS11TAG	TATGAAATTGGTAAAGTATTTAGAAATGAAGGTATAGATAATACATAGAATCCTGAATTTACTTCGTGTGAATTTTATTGGGCATATGCT	1864
KRS11CAT	TATGAAATTGGTAAAGTATTTAGAAATGAAGGTATAGATAATACACATAATCCTGAATTTACTTCGTGTGAATTTTATTGGGCATATGCT	53004
KRS11CAC	TATGAAATTGGTAAAGTATTTAGAAATGAAGGTATAGATAATACACACAATCCTGAATTTACTTCGTGTGAATTTTATTGGGCATATGCT	194
KRS11CAA	TATGAAATTGGTAAAGTATTTAGAAATGAAGGTATAGATAATACACAAAATCCTGAATTTACTTCGTGTGAATTTTATTGGGCATATGCT	1753
KRS11CAG	TATGAAATTGGTAAAGTATTTAGAAATGAAGGTATAGATAATACACAGAATCCTGAATTTACTTCGTGTGAATTTTATTGGGCATATGCT	67
KRS11AAT	TATGAAATTGGTAAAGTATTTAGAAATGAAGGTATAGATAATACAAATAATCCTGAATTTACTTCGTGTGAATTTTATTGGGCATATGCT	2263
KRS11AAC	TATGAAATTGGTAAAGTATTTAGAAATGAAGGTATAGATAATACAAACAATCCTGAATTTACTTCGTGTGAATTTTATTGGGCATATGCT	2747
KRS11AAA	TATGAAATTGGTAAAGTATTTAGAAATGAAGGTATAGATAATACAAAAAATCCTGAATTTACTTCGTGTGAATTTTATTGGGCATATGCT	32213
KRS11AAG	TATGAAATTGGTAAAGTATTTAGAAATGAAGGTATAGATAATACAAAGAATCCTGAATTTACTTCGTGTGAATTTTATTGGGCATATGCT	278
KRS11GAT	TATGAAATTGGTAAAGTATTTAGAAATGAAGGTATAGATAATACAGATAATCCTGAATTTACTTCGTGTGAATTTTATTGGGCATATGCT	735
KRS11GAC	TATGAAATTGGTAAAGTATTTAGAAATGAAGGTATAGATAATACAGACAATCCTGAATTTACTTCGTGTGAATTTTATTGGGCATATGCT	462
KRS11GAA	TATGAAATTGGTAAAGTATTTAGAAATGAAGGTATAGATAATACAGAAAATCCTGAATTTACTTCGTGTGAATTTTATTGGGCATATGCT	11320
KRS11GAG	TATGAAATTGGTAAAGTATTTAGAAATGAAGGTATAGATAATACAGAGAATCCTGAATTTACTTCGTGTGAATTTTATTGGGCATATGCT	144
KRS11TGT	TATGAAATTGGTAAAGTATTTAGAAATGAAGGTATAGATAATACATGTAATCCTGAATTTACTTCGTGTGAATTTTATTGGGCATATGCT	569
KRS11TGC	TATGAAATTGGTAAAGTATTTAGAAATGAAGGTATAGATAATACATGCAATCCTGAATTTACTTCGTGTGAATTTTATTGGGCATATGCT	947
KRS11TGA	TATGAAATTGGTAAAGTATTTAGAAATGAAGGTATAGATAATACATGAAATCCTGAATTTACTTCGTGTGAATTTTATTGGGCATATGCT	961
KRS11TGG	TATGAAATTGGTAAAGTATTTAGAAATGAAGGTATAGATAATACATGGAATCCTGAATTTACTTCGTGTGAATTTTATTGGGCATATGCT	366
KRS11CGT	TATGAAATTGGTAAAGTATTTAGAAATGAAGGTATAGATAATACACGTAATCCTGAATTTACTTCGTGTGAATTTTATTGGGCATATGCT	108
KRS11CGC	TATGAAATTGGTAAAGTATTTAGAAATGAAGGTATAGATAATACACGCAATCCTGAATTTACTTCGTGTGAATTTTATTGGGCATATGCT	16
KRS11CGA	TATGAAATTGGTAAAGTATTTAGAAATGAAGGTATAGATAATACACGAAATCCTGAATTTACTTCGTGTGAATTTTATTGGGCATATGCT	32
KRS11CGG	TATGAAATTGGTAAAGTATTTAGAAATGAAGGTATAGATAATACACGGAATCCTGAATTTACTTCGTGTGAATTTTATTGGGCATATGCT	210
KRS11AGT	TATGAAATTGGTAAAGTATTTAGAAATGAAGGTATAGATAATACAAGTAATCCTGAATTTACTTCGTGTGAATTTTATTGGGCATATGCT	102
KRS11AGC	TATGAAATTGGTAAAGTATTTAGAAATGAAGGTATAGATAATACAAGCAATCCTGAATTTACTTCGTGTGAATTTTATTGGGCATATGCT	91
KRS11AGA	TATGAAATTGGTAAAGTATTTAGAAATGAAGGTATAGATAATACAAGAAATCCTGAATTTACTTCGTGTGAATTTTATTGGGCATATGCT	2110
KRS11AGG	TATGAAATTGGTAAAGTATTTAGAAATGAAGGTATAGATAATACAAGGAATCCTGAATTTACTTCGTGTGAATTTTATTGGGCATATGCT	83
KRS11GGT	TATGAAATTGGTAAAGTATTTAGAAATGAAGGTATAGATAATACAGGTAATCCTGAATTTACTTCGTGTGAATTTTATTGGGCATATGCT	202
KRS11GGC	TATGAAATTGGTAAAGTATTTAGAAATGAAGGTATAGATAATACAGGCAATCCTGAATTTACTTCGTGTGAATTTTATTGGGCATATGCT	96
KRS11GGA	TATGAAATTGGTAAAGTATTTAGAAATGAAGGTATAGATAATACAGGAAATCCTGAATTTACTTCGTGTGAATTTTATTGGGCATATGCT	179
KRS11GGG	TATGAAATTGGTAAAGTATTTAGAAATGAAGGTATAGATAATACAGGGAATCCTGAATTTACTTCGTGTGAATTTTATTGGGCATATGCT	74
KRS12TTT	TATGAAATTGGTAAAGTATTTAGAAATGAAGGTATAGATAATACACATTTTCCTGAATTTACTTCGTGTGAATTTTATTGGGCATATGCT	3244
KRS12TTC	TATGAAATTGGTAAAGTATTTAGAAATGAAGGTATAGATAATACACATTTCCCTGAATTTACTTCGTGTGAATTTTATTGGGCATATGCT	1642
KRS12TTA	TATGAAATTGGTAAAGTATTTAGAAATGAAGGTATAGATAATACACATTTACCTGAATTTACTTCGTGTGAATTTTATTGGGCATATGCT	3030
KRS12TTG	TATGAAATTGGTAAAGTATTTAGAAATGAAGGTATAGATAATACACATTTGCCTGAATTTACTTCGTGTGAATTTTATTGGGCATATGCT	708
KRS12CTT	TATGAAATTGGTAAAGTATTTAGAAATGAAGGTATAGATAATACACATCTTCCTGAATTTACTTCGTGTGAATTTTATTGGGCATATGCT	968
KRS12CTC	TATGAAATTGGTAAAGTATTTAGAAATGAAGGTATAGATAATACACATCTCCCTGAATTTACTTCGTGTGAATTTTATTGGGCATATGCT	363
KRS12CTA	TATGAAATTGGTAAAGTATTTAGAAATGAAGGTATAGATAATACACATCTACCTGAATTTACTTCGTGTGAATTTTATTGGGCATATGCT	829
KRS12CTG	TATGAAATTGGTAAAGTATTTAGAAATGAAGGTATAGATAATACACATCTGCCTGAATTTACTTCGTGTGAATTTTATTGGGCATATGCT	421
KRS12ATT	TATGAAATTGGTAAAGTATTTAGAAATGAAGGTATAGATAATACACATATTCCTGAATTTACTTCGTGTGAATTTTATTGGGCATATGCT	1287
KRS12ATC	TATGAAATTGGTAAAGTATTTAGAAATGAAGGTATAGATAATACACATATCCCTGAATTTACTTCGTGTGAATTTTATTGGGCATATGCT	505
KRS12ATA	TATGAAATTGGTAAAGTATTTAGAAATGAAGGTATAGATAATACACATATACCTGAATTTACTTCGTGTGAATTTTATTGGGCATATGCT	3264
KRS12ATG	TATGAAATTGGTAAAGTATTTAGAAATGAAGGTATAGATAATACACATATGCCTGAATTTACTTCGTGTGAATTTTATTGGGCATATGCT	597
KRS12GTT	TATGAAATTGGTAAAGTATTTAGAAATGAAGGTATAGATAATACACATGTTCCTGAATTTACTTCGTGTGAATTTTATTGGGCATATGCT	1443
KRS12GTC	TATGAAATTGGTAAAGTATTTAGAAATGAAGGTATAGATAATACACATGTCCCTGAATTTACTTCGTGTGAATTTTATTGGGCATATGCT	355
KRS12GTA	TATGAAATTGGTAAAGTATTTAGAAATGAAGGTATAGATAATACACATGTACCTGAATTTACTTCGTGTGAATTTTATTGGGCATATGCT	1628
KRS12GTG	TATGAAATTGGTAAAGTATTTAGAAATGAAGGTATAGATAATACACATGTGCCTGAATTTACTTCGTGTGAATTTTATTGGGCATATGCT	375
KRS12TCT	TATGAAATTGGTAAAGTATTTAGAAATGAAGGTATAGATAATACACATTCTCCTGAATTTACTTCGTGTGAATTTTATTGGGCATATGCT	653
KRS12TCC	TATGAAATTGGTAAAGTATTTAGAAATGAAGGTATAGATAATACACATTCCCCTGAATTTACTTCGTGTGAATTTTATTGGGCATATGCT	313
KRS12TCA	TATGAAATTGGTAAAGTATTTAGAAATGAAGGTATAGATAATACACATTCACCTGAATTTACTTCGTGTGAATTTTATTGGGCATATGCT	891
KRS12TCG	TATGAAATTGGTAAAGTATTTAGAAATGAAGGTATAGATAATACACATTCGCCTGAATTTACTTCGTGTGAATTTTATTGGGCATATGCT	380
KRS12CCT	TATGAAATTGGTAAAGTATTTAGAAATGAAGGTATAGATAATACACATCCTCCTGAATTTACTTCGTGTGAATTTTATTGGGCATATGCT	207
KRS12CCC	TATGAAATTGGTAAAGTATTTAGAAATGAAGGTATAGATAATACACATCCCCCTGAATTTACTTCGTGTGAATTTTATTGGGCATATGCT	104
KRS12CCA	TATGAAATTGGTAAAGTATTTAGAAATGAAGGTATAGATAATACACATCCACCTGAATTTACTTCGTGTGAATTTTATTGGGCATATGCT	164
KRS12CCG	TATGAAATTGGTAAAGTATTTAGAAATGAAGGTATAGATAATACACATCCGCCTGAATTTACTTCGTGTGAATTTTATTGGGCATATGCT	53
KRS12ACT	TATGAAATTGGTAAAGTATTTAGAAATGAAGGTATAGATAATACACATACTCCTGAATTTACTTCGTGTGAATTTTATTGGGCATATGCT	898
KRS12ACC	TATGAAATTGGTAAAGTATTTAGAAATGAAGGTATAGATAATACACATACCCCTGAATTTACTTCGTGTGAATTTTATTGGGCATATGCT	168
KRS12ACA	TATGAAATTGGTAAAGTATTTAGAAATGAAGGTATAGATAATACACATACACCTGAATTTACTTCGTGTGAATTTTATTGGGCATATGCT	2490
KRS12ACG	TATGAAATTGGTAAAGTATTTAGAAATGAAGGTATAGATAATACACATACGCCTGAATTTACTTCGTGTGAATTTTATTGGGCATATGCT	272
KRS12GCT	TATGAAATTGGTAAAGTATTTAGAAATGAAGGTATAGATAATACACATGCTCCTGAATTTACTTCGTGTGAATTTTATTGGGCATATGCT	247
KRS12GCC	TATGAAATTGGTAAAGTATTTAGAAATGAAGGTATAGATAATACACATGCCCCTGAATTTACTTCGTGTGAATTTTATTGGGCATATGCT	100
KRS12GCA	TATGAAATTGGTAAAGTATTTAGAAATGAAGGTATAGATAATACACATGCACCTGAATTTACTTCGTGTGAATTTTATTGGGCATATGCT	216
KRS12GCG	TATGAAATTGGTAAAGTATTTAGAAATGAAGGTATAGATAATACACATGCGCCTGAATTTACTTCGTGTGAATTTTATTGGGCATATGCT	60
KRS12TAT	TATGAAATTGGTAAAGTATTTAGAAATGAAGGTATAGATAATACACATTATCCTGAATTTACTTCGTGTGAATTTTATTGGGCATATGCT	1078
KRS12TAC	TATGAAATTGGTAAAGTATTTAGAAATGAAGGTATAGATAATACACATTACCCTGAATTTACTTCGTGTGAATTTTATTGGGCATATGCT	470
KRS12TAA	TATGAAATTGGTAAAGTATTTAGAAATGAAGGTATAGATAATACACATTAACCTGAATTTACTTCGTGTGAATTTTATTGGGCATATGCT	9042
KRS12TAG	TATGAAATTGGTAAAGTATTTAGAAATGAAGGTATAGATAATACACATTAGCCTGAATTTACTTCGTGTGAATTTTATTGGGCATATGCT	281
KRS12CAT	TATGAAATTGGTAAAGTATTTAGAAATGAAGGTATAGATAATACACATCATCCTGAATTTACTTCGTGTGAATTTTATTGGGCATATGCT	1558
KRS12CAC	TATGAAATTGGTAAAGTATTTAGAAATGAAGGTATAGATAATACACATCACCCTGAATTTACTTCGTGTGAATTTTATTGGGCATATGCT	170
KRS12CAA	TATGAAATTGGTAAAGTATTTAGAAATGAAGGTATAGATAATACACATCAACCTGAATTTACTTCGTGTGAATTTTATTGGGCATATGCT	1178
KRS12CAG	TATGAAATTGGTAAAGTATTTAGAAATGAAGGTATAGATAATACACATCAGCCTGAATTTACTTCGTGTGAATTTTATTGGGCATATGCT	94
KRS12AAT	TATGAAATTGGTAAAGTATTTAGAAATGAAGGTATAGATAATACACATAATCCTGAATTTACTTCGTGTGAATTTTATTGGGCATATGCT	53004
KRS12AAC	TATGAAATTGGTAAAGTATTTAGAAATGAAGGTATAGATAATACACATAACCCTGAATTTACTTCGTGTGAATTTTATTGGGCATATGCT	891
KRS12AAA	TATGAAATTGGTAAAGTATTTAGAAATGAAGGTATAGATAATACACATAAACCTGAATTTACTTCGTGTGAATTTTATTGGGCATATGCT	27358
KRS12AAG	TATGAAATTGGTAAAGTATTTAGAAATGAAGGTATAGATAATACACATAAGCCTGAATTTACTTCGTGTGAATTTTATTGGGCATATGCT	745
KRS12GAT	TATGAAATTGGTAAAGTATTTAGAAATGAAGGTATAGATAATACACATGATCCTGAATTTACTTCGTGTGAATTTTATTGGGCATATGCT	981
KRS12GAC	TATGAAATTGGTAAAGTATTTAGAAATGAAGGTATAGATAATACACATGACCCTGAATTTACTTCGTGTGAATTTTATTGGGCATATGCT	79
KRS12GAA	TATGAAATTGGTAAAGTATTTAGAAATGAAGGTATAGATAATACACATGAACCTGAATTTACTTCGTGTGAATTTTATTGGGCATATGCT	2555
KRS12GAG	TATGAAATTGGTAAAGTATTTAGAAATGAAGGTATAGATAATACACATGAGCCTGAATTTACTTCGTGTGAATTTTATTGGGCATATGCT	1099
KRS12TGT	TATGAAATTGGTAAAGTATTTAGAAATGAAGGTATAGATAATACACATTGTCCTGAATTTACTTCGTGTGAATTTTATTGGGCATATGCT	477
KRS12TGC	TATGAAATTGGTAAAGTATTTAGAAATGAAGGTATAGATAATACACATTGCCCTGAATTTACTTCGTGTGAATTTTATTGGGCATATGCT	169
KRS12TGA	TATGAAATTGGTAAAGTATTTAGAAATGAAGGTATAGATAATACACATTGACCTGAATTTACTTCGTGTGAATTTTATTGGGCATATGCT	274
KRS12TGG	TATGAAATTGGTAAAGTATTTAGAAATGAAGGTATAGATAATACACATTGGCCTGAATTTACTTCGTGTGAATTTTATTGGGCATATGCT	66
KRS12CGT	TATGAAATTGGTAAAGTATTTAGAAATGAAGGTATAGATAATACACATCGTCCTGAATTTACTTCGTGTGAATTTTATTGGGCATATGCT	98
KRS12CGC	TATGAAATTGGTAAAGTATTTAGAAATGAAGGTATAGATAATACACATCGCCCTGAATTTACTTCGTGTGAATTTTATTGGGCATATGCT	41
KRS12CGA	TATGAAATTGGTAAAGTATTTAGAAATGAAGGTATAGATAATACACATCGACCTGAATTTACTTCGTGTGAATTTTATTGGGCATATGCT	57
KRS12CGG	TATGAAATTGGTAAAGTATTTAGAAATGAAGGTATAGATAATACACATCGGCCTGAATTTACTTCGTGTGAATTTTATTGGGCATATGCT	22
KRS12AGT	TATGAAATTGGTAAAGTATTTAGAAATGAAGGTATAGATAATACACATAGTCCTGAATTTACTTCGTGTGAATTTTATTGGGCATATGCT	310
KRS12AGC	TATGAAATTGGTAAAGTATTTAGAAATGAAGGTATAGATAATACACATAGCCCTGAATTTACTTCGTGTGAATTTTATTGGGCATATGCT	90
KRS12AGA	TATGAAATTGGTAAAGTATTTAGAAATGAAGGTATAGATAATACACATAGACCTGAATTTACTTCGTGTGAATTTTATTGGGCATATGCT	421
KRS12AGG	TATGAAATTGGTAAAGTATTTAGAAATGAAGGTATAGATAATACACATAGGCCTGAATTTACTTCGTGTGAATTTTATTGGGCATATGCT	54
KRS12GGT	TATGAAATTGGTAAAGTATTTAGAAATGAAGGTATAGATAATACACATGGTCCTGAATTTACTTCGTGTGAATTTTATTGGGCATATGCT	17567
KRS12GGC	TATGAAATTGGTAAAGTATTTAGAAATGAAGGTATAGATAATACACATGGCCCTGAATTTACTTCGTGTGAATTTTATTGGGCATATGCT	174
KRS12GGA	TATGAAATTGGTAAAGTATTTAGAAATGAAGGTATAGATAATACACATGGACCTGAATTTACTTCGTGTGAATTTTATTGGGCATATGCT	174
KRS12GGG	TATGAAATTGGTAAAGTATTTAGAAATGAAGGTATAGATAATACACATGGGCCTGAATTTACTTCGTGTGAATTTTATTGGGCATATGCT	63
KRS13TTT	TATGAAATTGGTAAAGTATTTAGAAATGAAGGTATAGATAATACACATAATTTTGAATTTACTTCGTGTGAATTTTATTGGGCATATGCT	2355
KRS13TTC	TATGAAATTGGTAAAGTATTTAGAAATGAAGGTATAGATAATACACATAATTTCGAATTTACTTCGTGTGAATTTTATTGGGCATATGCT	536
KRS13TTA	TATGAAATTGGTAAAGTATTTAGAAATGAAGGTATAGATAATACACATAATTTAGAATTTACTTCGTGTGAATTTTATTGGGCATATGCT	2140
KRS13TTG	TATGAAATTGGTAAAGTATTTAGAAATGAAGGTATAGATAATACACATAATTTGGAATTTACTTCGTGTGAATTTTATTGGGCATATGCT	1654
KRS13CTT	TATGAAATTGGTAAAGTATTTAGAAATGAAGGTATAGATAATACACATAATCTTGAATTTACTTCGTGTGAATTTTATTGGGCATATGCT	1030
KRS13CTC	TATGAAATTGGTAAAGTATTTAGAAATGAAGGTATAGATAATACACATAATCTCGAATTTACTTCGTGTGAATTTTATTGGGCATATGCT	196
KRS13CTA	TATGAAATTGGTAAAGTATTTAGAAATGAAGGTATAGATAATACACATAATCTAGAATTTACTTCGTGTGAATTTTATTGGGCATATGCT	2214
KRS13CTG	TATGAAATTGGTAAAGTATTTAGAAATGAAGGTATAGATAATACACATAATCTGGAATTTACTTCGTGTGAATTTTATTGGGCATATGCT	506
KRS13ATT	TATGAAATTGGTAAAGTATTTAGAAATGAAGGTATAGATAATACACATAATATTGAATTTACTTCGTGTGAATTTTATTGGGCATATGCT	1962
KRS13ATC	TATGAAATTGGTAAAGTATTTAGAAATGAAGGTATAGATAATACACATAATATCGAATTTACTTCGTGTGAATTTTATTGGGCATATGCT	434
KRS13ATA	TATGAAATTGGTAAAGTATTTAGAAATGAAGGTATAGATAATACACATAATATAGAATTTACTTCGTGTGAATTTTATTGGGCATATGCT	2117
KRS13ATG	TATGAAATTGGTAAAGTATTTAGAAATGAAGGTATAGATAATACACATAATATGGAATTTACTTCGTGTGAATTTTATTGGGCATATGCT	1005
KRS13GTT	TATGAAATTGGTAAAGTATTTAGAAATGAAGGTATAGATAATACACATAATGTTGAATTTACTTCGTGTGAATTTTATTGGGCATATGCT	1168
KRS13GTC	TATGAAATTGGTAAAGTATTTAGAAATGAAGGTATAGATAATACACATAATGTCGAATTTACTTCGTGTGAATTTTATTGGGCATATGCT	157
KRS13GTA	TATGAAATTGGTAAAGTATTTAGAAATGAAGGTATAGATAATACACATAATGTAGAATTTACTTCGTGTGAATTTTATTGGGCATATGCT	777
KRS13GTG	TATGAAATTGGTAAAGTATTTAGAAATGAAGGTATAGATAATACACATAATGTGGAATTTACTTCGTGTGAATTTTATTGGGCATATGCT	784
KRS13TCT	TATGAAATTGGTAAAGTATTTAGAAATGAAGGTATAGATAATACACATAATTCTGAATTTACTTCGTGTGAATTTTATTGGGCATATGCT	1508
KRS13TCC	TATGAAATTGGTAAAGTATTTAGAAATGAAGGTATAGATAATACACATAATTCCGAATTTACTTCGTGTGAATTTTATTGGGCATATGCT	202
KRS13TCA	TATGAAATTGGTAAAGTATTTAGAAATGAAGGTATAGATAATACACATAATTCAGAATTTACTTCGTGTGAATTTTATTGGGCATATGCT	3465
KRS13TCG	TATGAAATTGGTAAAGTATTTAGAAATGAAGGTATAGATAATACACATAATTCGGAATTTACTTCGTGTGAATTTTATTGGGCATATGCT	189
KRS13CCT	TATGAAATTGGTAAAGTATTTAGAAATGAAGGTATAGATAATACACATAATCCTGAATTTACTTCGTGTGAATTTTATTGGGCATATGCT	53004
KRS13CCC	TATGAAATTGGTAAAGTATTTAGAAATGAAGGTATAGATAATACACATAATCCCGAATTTACTTCGTGTGAATTTTATTGGGCATATGCT	190
KRS13CCA	TATGAAATTGGTAAAGTATTTAGAAATGAAGGTATAGATAATACACATAATCCAGAATTTACTTCGTGTGAATTTTATTGGGCATATGCT	758
KRS13CCG	TATGAAATTGGTAAAGTATTTAGAAATGAAGGTATAGATAATACACATAATCCGGAATTTACTTCGTGTGAATTTTATTGGGCATATGCT	104
KRS13ACT	TATGAAATTGGTAAAGTATTTAGAAATGAAGGTATAGATAATACACATAATACTGAATTTACTTCGTGTGAATTTTATTGGGCATATGCT	596
KRS13ACC	TATGAAATTGGTAAAGTATTTAGAAATGAAGGTATAGATAATACACATAATACCGAATTTACTTCGTGTGAATTTTATTGGGCATATGCT	169
KRS13ACA	TATGAAATTGGTAAAGTATTTAGAAATGAAGGTATAGATAATACACATAATACAGAATTTACTTCGTGTGAATTTTATTGGGCATATGCT	2256
KRS13ACG	TATGAAATTGGTAAAGTATTTAGAAATGAAGGTATAGATAATACACATAATACGGAATTTACTTCGTGTGAATTTTATTGGGCATATGCT	370
KRS13GCT	TATGAAATTGGTAAAGTATTTAGAAATGAAGGTATAGATAATACACATAATGCTGAATTTACTTCGTGTGAATTTTATTGGGCATATGCT	601
KRS13GCC	TATGAAATTGGTAAAGTATTTAGAAATGAAGGTATAGATAATACACATAATGCCGAATTTACTTCGTGTGAATTTTATTGGGCATATGCT	72
KRS13GCA	TATGAAATTGGTAAAGTATTTAGAAATGAAGGTATAGATAATACACATAATGCAGAATTTACTTCGTGTGAATTTTATTGGGCATATGCT	463
KRS13GCG	TATGAAATTGGTAAAGTATTTAGAAATGAAGGTATAGATAATACACATAATGCGGAATTTACTTCGTGTGAATTTTATTGGGCATATGCT	95
KRS13TAT	TATGAAATTGGTAAAGTATTTAGAAATGAAGGTATAGATAATACACATAATTATGAATTTACTTCGTGTGAATTTTATTGGGCATATGCT	1354
KRS13TAC	TATGAAATTGGTAAAGTATTTAGAAATGAAGGTATAGATAATACACATAATTACGAATTTACTTCGTGTGAATTTTATTGGGCATATGCT	442
KRS13TAA	TATGAAATTGGTAAAGTATTTAGAAATGAAGGTATAGATAATACACATAATTAAGAATTTACTTCGTGTGAATTTTATTGGGCATATGCT	3974
KRS13TAG	TATGAAATTGGTAAAGTATTTAGAAATGAAGGTATAGATAATACACATAATTAGGAATTTACTTCGTGTGAATTTTATTGGGCATATGCT	377
KRS13CAT	TATGAAATTGGTAAAGTATTTAGAAATGAAGGTATAGATAATACACATAATCATGAATTTACTTCGTGTGAATTTTATTGGGCATATGCT	1138
KRS13CAC	TATGAAATTGGTAAAGTATTTAGAAATGAAGGTATAGATAATACACATAATCACGAATTTACTTCGTGTGAATTTTATTGGGCATATGCT	547
KRS13CAA	TATGAAATTGGTAAAGTATTTAGAAATGAAGGTATAGATAATACACATAATCAAGAATTTACTTCGTGTGAATTTTATTGGGCATATGCT	2770
KRS13CAG	TATGAAATTGGTAAAGTATTTAGAAATGAAGGTATAGATAATACACATAATCAGGAATTTACTTCGTGTGAATTTTATTGGGCATATGCT	309
KRS13AAT	TATGAAATTGGTAAAGTATTTAGAAATGAAGGTATAGATAATACACATAATAATGAATTTACTTCGTGTGAATTTTATTGGGCATATGCT	1305
KRS13AAC	TATGAAATTGGTAAAGTATTTAGAAATGAAGGTATAGATAATACACATAATAACGAATTTACTTCGTGTGAATTTTATTGGGCATATGCT	1028
KRS13AAA	TATGAAATTGGTAAAGTATTTAGAAATGAAGGTATAGATAATACACATAATAAAGAATTTACTTCGTGTGAATTTTATTGGGCATATGCT	6035
KRS13AAG	TATGAAATTGGTAAAGTATTTAGAAATGAAGGTATAGATAATACACATAATAAGGAATTTACTTCGTGTGAATTTTATTGGGCATATGCT	480
KRS13GAT	TATGAAATTGGTAAAGTATTTAGAAATGAAGGTATAGATAATACACATAATGATGAATTTACTTCGTGTGAATTTTATTGGGCATATGCT	500
KRS13GAC	TATGAAATTGGTAAAGTATTTAGAAATGAAGGTATAGATAATACACATAATGACGAATTTACTTCGTGTGAATTTTATTGGGCATATGCT	383
KRS13GAA	TATGAAATTGGTAAAGTATTTAGAAATGAAGGTATAGATAATACACATAATGAAGAATTTACTTCGTGTGAATTTTATTGGGCATATGCT	2112
KRS13GAG	TATGAAATTGGTAAAGTATTTAGAAATGAAGGTATAGATAATACACATAATGAGGAATTTACTTCGTGTGAATTTTATTGGGCATATGCT	227
KRS13TGT	TATGAAATTGGTAAAGTATTTAGAAATGAAGGTATAGATAATACACATAATTGTGAATTTACTTCGTGTGAATTTTATTGGGCATATGCT	1190
KRS13TGC	TATGAAATTGGTAAAGTATTTAGAAATGAAGGTATAGATAATACACATAATTGCGAATTTACTTCGTGTGAATTTTATTGGGCATATGCT	300
KRS13TGA	TATGAAATTGGTAAAGTATTTAGAAATGAAGGTATAGATAATACACATAATTGAGAATTTACTTCGTGTGAATTTTATTGGGCATATGCT	866
KRS13TGG	TATGAAATTGGTAAAGTATTTAGAAATGAAGGTATAGATAATACACATAATTGGGAATTTACTTCGTGTGAATTTTATTGGGCATATGCT	651
KRS13CGT	TATGAAATTGGTAAAGTATTTAGAAATGAAGGTATAGATAATACACATAATCGTGAATTTACTTCGTGTGAATTTTATTGGGCATATGCT	413
KRS13CGC	TATGAAATTGGTAAAGTATTTAGAAATGAAGGTATAGATAATACACATAATCGCGAATTTACTTCGTGTGAATTTTATTGGGCATATGCT	147
KRS13CGA	TATGAAATTGGTAAAGTATTTAGAAATGAAGGTATAGATAATACACATAATCGAGAATTTACTTCGTGTGAATTTTATTGGGCATATGCT	252
KRS13CGG	TATGAAATTGGTAAAGTATTTAGAAATGAAGGTATAGATAATACACATAATCGGGAATTTACTTCGTGTGAATTTTATTGGGCATATGCT	159
KRS13AGT	TATGAAATTGGTAAAGTATTTAGAAATGAAGGTATAGATAATACACATAATAGTGAATTTACTTCGTGTGAATTTTATTGGGCATATGCT	636
KRS13AGC	TATGAAATTGGTAAAGTATTTAGAAATGAAGGTATAGATAATACACATAATAGCGAATTTACTTCGTGTGAATTTTATTGGGCATATGCT	297
KRS13AGA	TATGAAATTGGTAAAGTATTTAGAAATGAAGGTATAGATAATACACATAATAGAGAATTTACTTCGTGTGAATTTTATTGGGCATATGCT	1269
KRS13AGG	TATGAAATTGGTAAAGTATTTAGAAATGAAGGTATAGATAATACACATAATAGGGAATTTACTTCGTGTGAATTTTATTGGGCATATGCT	280
KRS13GGT	TATGAAATTGGTAAAGTATTTAGAAATGAAGGTATAGATAATACACATAATGGTGAATTTACTTCGTGTGAATTTTATTGGGCATATGCT	443
KRS13GGC	TATGAAATTGGTAAAGTATTTAGAAATGAAGGTATAGATAATACACATAATGGCGAATTTACTTCGTGTGAATTTTATTGGGCATATGCT	128
KRS13GGA	TATGAAATTGGTAAAGTATTTAGAAATGAAGGTATAGATAATACACATAATGGAGAATTTACTTCGTGTGAATTTTATTGGGCATATGCT	631
KRS13GGG	TATGAAATTGGTAAAGTATTTAGAAATGAAGGTATAGATAATACACATAATGGGGAATTTACTTCGTGTGAATTTTATTGGGCATATGCT	1887
KRS14TTT	TATGAAATTGGTAAAGTATTTAGAAATGAAGGTATAGATAATACACATAATCCTTTTTTTACTTCGTGTGAATTTTATTGGGCATATGCT	1229
KRS14TTC	TATGAAATTGGTAAAGTATTTAGAAATGAAGGTATAGATAATACACATAATCCTTTCTTTACTTCGTGTGAATTTTATTGGGCATATGCT	514
KRS14TTA	TATGAAATTGGTAAAGTATTTAGAAATGAAGGTATAGATAATACACATAATCCTTTATTTACTTCGTGTGAATTTTATTGGGCATATGCT	2320
KRS14TTG	TATGAAATTGGTAAAGTATTTAGAAATGAAGGTATAGATAATACACATAATCCTTTGTTTACTTCGTGTGAATTTTATTGGGCATATGCT	1356
KRS14CTT	TATGAAATTGGTAAAGTATTTAGAAATGAAGGTATAGATAATACACATAATCCTCTTTTTACTTCGTGTGAATTTTATTGGGCATATGCT	783
KRS14CTC	TATGAAATTGGTAAAGTATTTAGAAATGAAGGTATAGATAATACACATAATCCTCTCTTTACTTCGTGTGAATTTTATTGGGCATATGCT	296
KRS14CTA	TATGAAATTGGTAAAGTATTTAGAAATGAAGGTATAGATAATACACATAATCCTCTATTTACTTCGTGTGAATTTTATTGGGCATATGCT	640
KRS14CTG	TATGAAATTGGTAAAGTATTTAGAAATGAAGGTATAGATAATACACATAATCCTCTGTTTACTTCGTGTGAATTTTATTGGGCATATGCT	368
KRS14ATT	TATGAAATTGGTAAAGTATTTAGAAATGAAGGTATAGATAATACACATAATCCTATTTTTACTTCGTGTGAATTTTATTGGGCATATGCT	1657
KRS14ATC	TATGAAATTGGTAAAGTATTTAGAAATGAAGGTATAGATAATACACATAATCCTATCTTTACTTCGTGTGAATTTTATTGGGCATATGCT	322
KRS14ATA	TATGAAATTGGTAAAGTATTTAGAAATGAAGGTATAGATAATACACATAATCCTATATTTACTTCGTGTGAATTTTATTGGGCATATGCT	3385
KRS14ATG	TATGAAATTGGTAAAGTATTTAGAAATGAAGGTATAGATAATACACATAATCCTATGTTTACTTCGTGTGAATTTTATTGGGCATATGCT	29317
KRS14GTT	TATGAAATTGGTAAAGTATTTAGAAATGAAGGTATAGATAATACACATAATCCTGTTTTTACTTCGTGTGAATTTTATTGGGCATATGCT	1555
KRS14GTC	TATGAAATTGGTAAAGTATTTAGAAATGAAGGTATAGATAATACACATAATCCTGTCTTTACTTCGTGTGAATTTTATTGGGCATATGCT	381
KRS14GTA	TATGAAATTGGTAAAGTATTTAGAAATGAAGGTATAGATAATACACATAATCCTGTATTTACTTCGTGTGAATTTTATTGGGCATATGCT	850
KRS14GTG	TATGAAATTGGTAAAGTATTTAGAAATGAAGGTATAGATAATACACATAATCCTGTGTTTACTTCGTGTGAATTTTATTGGGCATATGCT	934
KRS14TCT	TATGAAATTGGTAAAGTATTTAGAAATGAAGGTATAGATAATACACATAATCCTTCTTTTACTTCGTGTGAATTTTATTGGGCATATGCT	518
KRS14TCC	TATGAAATTGGTAAAGTATTTAGAAATGAAGGTATAGATAATACACATAATCCTTCCTTTACTTCGTGTGAATTTTATTGGGCATATGCT	193
KRS14TCA	TATGAAATTGGTAAAGTATTTAGAAATGAAGGTATAGATAATACACATAATCCTTCATTTACTTCGTGTGAATTTTATTGGGCATATGCT	426
KRS14TCG	TATGAAATTGGTAAAGTATTTAGAAATGAAGGTATAGATAATACACATAATCCTTCGTTTACTTCGTGTGAATTTTATTGGGCATATGCT	231
KRS14CCT	TATGAAATTGGTAAAGTATTTAGAAATGAAGGTATAGATAATACACATAATCCTCCTTTTACTTCGTGTGAATTTTATTGGGCATATGCT	309
KRS14CCC	TATGAAATTGGTAAAGTATTTAGAAATGAAGGTATAGATAATACACATAATCCTCCCTTTACTTCGTGTGAATTTTATTGGGCATATGCT	141
KRS14CCA	TATGAAATTGGTAAAGTATTTAGAAATGAAGGTATAGATAATACACATAATCCTCCATTTACTTCGTGTGAATTTTATTGGGCATATGCT	239
KRS14CCG	TATGAAATTGGTAAAGTATTTAGAAATGAAGGTATAGATAATACACATAATCCTCCGTTTACTTCGTGTGAATTTTATTGGGCATATGCT	98
KRS14ACT	TATGAAATTGGTAAAGTATTTAGAAATGAAGGTATAGATAATACACATAATCCTACTTTTACTTCGTGTGAATTTTATTGGGCATATGCT	417
KRS14ACC	TATGAAATTGGTAAAGTATTTAGAAATGAAGGTATAGATAATACACATAATCCTACCTTTACTTCGTGTGAATTTTATTGGGCATATGCT	188
KRS14ACA	TATGAAATTGGTAAAGTATTTAGAAATGAAGGTATAGATAATACACATAATCCTACATTTACTTCGTGTGAATTTTATTGGGCATATGCT	1120
KRS14ACG	TATGAAATTGGTAAAGTATTTAGAAATGAAGGTATAGATAATACACATAATCCTACGTTTACTTCGTGTGAATTTTATTGGGCATATGCT	226
KRS14GCT	TATGAAATTGGTAAAGTATTTAGAAATGAAGGTATAGATAATACACATAATCCTGCTTTTACTTCGTGTGAATTTTATTGGGCATATGCT	499
KRS14GCC	TATGAAATTGGTAAAGTATTTAGAAATGAAGGTATAGATAATACACATAATCCTGCCTTTACTTCGTGTGAATTTTATTGGGCATATGCT	237
KRS14GCA	TATGAAATTGGTAAAGTATTTAGAAATGAAGGTATAGATAATACACATAATCCTGCATTTACTTCGTGTGAATTTTATTGGGCATATGCT	427
KRS14GCG	TATGAAATTGGTAAAGTATTTAGAAATGAAGGTATAGATAATACACATAATCCTGCGTTTACTTCGTGTGAATTTTATTGGGCATATGCT	690
KRS14TAT	TATGAAATTGGTAAAGTATTTAGAAATGAAGGTATAGATAATACACATAATCCTTATTTTACTTCGTGTGAATTTTATTGGGCATATGCT	2123
KRS14TAC	TATGAAATTGGTAAAGTATTTAGAAATGAAGGTATAGATAATACACATAATCCTTACTTTACTTCGTGTGAATTTTATTGGGCATATGCT	324
KRS14TAA	TATGAAATTGGTAAAGTATTTAGAAATGAAGGTATAGATAATACACATAATCCTTAATTTACTTCGTGTGAATTTTATTGGGCATATGCT	2682
KRS14TAG	TATGAAATTGGTAAAGTATTTAGAAATGAAGGTATAGATAATACACATAATCCTTAGTTTACTTCGTGTGAATTTTATTGGGCATATGCT	436
KRS14CAT	TATGAAATTGGTAAAGTATTTAGAAATGAAGGTATAGATAATACACATAATCCTCATTTTACTTCGTGTGAATTTTATTGGGCATATGCT	826
KRS14CAC	TATGAAATTGGTAAAGTATTTAGAAATGAAGGTATAGATAATACACATAATCCTCACTTTACTTCGTGTGAATTTTATTGGGCATATGCT	240
KRS14CAA	TATGAAATTGGTAAAGTATTTAGAAATGAAGGTATAGATAATACACATAATCCTCAATTTACTTCGTGTGAATTTTATTGGGCATATGCT	13908
KRS14CAG	TATGAAATTGGTAAAGTATTTAGAAATGAAGGTATAGATAATACACATAATCCTCAGTTTACTTCGTGTGAATTTTATTGGGCATATGCT	278
KRS14AAT	TATGAAATTGGTAAAGTATTTAGAAATGAAGGTATAGATAATACACATAATCCTAATTTTACTTCGTGTGAATTTTATTGGGCATATGCT	2753
KRS14AAC	TATGAAATTGGTAAAGTATTTAGAAATGAAGGTATAGATAATACACATAATCCTAACTTTACTTCGTGTGAATTTTATTGGGCATATGCT	1031
KRS14AAA	TATGAAATTGGTAAAGTATTTAGAAATGAAGGTATAGATAATACACATAATCCTAAATTTACTTCGTGTGAATTTTATTGGGCATATGCT	9169
KRS14AAG	TATGAAATTGGTAAAGTATTTAGAAATGAAGGTATAGATAATACACATAATCCTAAGTTTACTTCGTGTGAATTTTATTGGGCATATGCT	2035
KRS14GAT	TATGAAATTGGTAAAGTATTTAGAAATGAAGGTATAGATAATACACATAATCCTGATTTTACTTCGTGTGAATTTTATTGGGCATATGCT	1249
KRS14GAC	TATGAAATTGGTAAAGTATTTAGAAATGAAGGTATAGATAATACACATAATCCTGACTTTACTTCGTGTGAATTTTATTGGGCATATGCT	222
KRS14GAA	TATGAAATTGGTAAAGTATTTAGAAATGAAGGTATAGATAATACACATAATCCTGAATTTACTTCGTGTGAATTTTATTGGGCATATGCT	53004
KRS14GAG	TATGAAATTGGTAAAGTATTTAGAAATGAAGGTATAGATAATACACATAATCCTGAGTTTACTTCGTGTGAATTTTATTGGGCATATGCT	324
KRS14TGT	TATGAAATTGGTAAAGTATTTAGAAATGAAGGTATAGATAATACACATAATCCTTGTTTTACTTCGTGTGAATTTTATTGGGCATATGCT	687
KRS14TGC	TATGAAATTGGTAAAGTATTTAGAAATGAAGGTATAGATAATACACATAATCCTTGCTTTACTTCGTGTGAATTTTATTGGGCATATGCT	331
KRS14TGA	TATGAAATTGGTAAAGTATTTAGAAATGAAGGTATAGATAATACACATAATCCTTGATTTACTTCGTGTGAATTTTATTGGGCATATGCT	464
KRS14TGG	TATGAAATTGGTAAAGTATTTAGAAATGAAGGTATAGATAATACACATAATCCTTGGTTTACTTCGTGTGAATTTTATTGGGCATATGCT	698
KRS14CGT	TATGAAATTGGTAAAGTATTTAGAAATGAAGGTATAGATAATACACATAATCCTCGTTTTACTTCGTGTGAATTTTATTGGGCATATGCT	195
KRS14CGC	TATGAAATTGGTAAAGTATTTAGAAATGAAGGTATAGATAATACACATAATCCTCGCTTTACTTCGTGTGAATTTTATTGGGCATATGCT	109
KRS14CGA	TATGAAATTGGTAAAGTATTTAGAAATGAAGGTATAGATAATACACATAATCCTCGATTTACTTCGTGTGAATTTTATTGGGCATATGCT	183
KRS14CGG	TATGAAATTGGTAAAGTATTTAGAAATGAAGGTATAGATAATACACATAATCCTCGGTTTACTTCGTGTGAATTTTATTGGGCATATGCT	129
KRS14AGT	TATGAAATTGGTAAAGTATTTAGAAATGAAGGTATAGATAATACACATAATCCTAGTTTTACTTCGTGTGAATTTTATTGGGCATATGCT	983
KRS14AGC	TATGAAATTGGTAAAGTATTTAGAAATGAAGGTATAGATAATACACATAATCCTAGCTTTACTTCGTGTGAATTTTATTGGGCATATGCT	383
KRS14AGA	TATGAAATTGGTAAAGTATTTAGAAATGAAGGTATAGATAATACACATAATCCTAGATTTACTTCGTGTGAATTTTATTGGGCATATGCT	1105
KRS14AGG	TATGAAATTGGTAAAGTATTTAGAAATGAAGGTATAGATAATACACATAATCCTAGGTTTACTTCGTGTGAATTTTATTGGGCATATGCT	219
KRS14GGT	TATGAAATTGGTAAAGTATTTAGAAATGAAGGTATAGATAATACACATAATCCTGGTTTTACTTCGTGTGAATTTTATTGGGCATATGCT	715
KRS14GGC	TATGAAATTGGTAAAGTATTTAGAAATGAAGGTATAGATAATACACATAATCCTGGCTTTACTTCGTGTGAATTTTATTGGGCATATGCT	247
KRS14GGA	TATGAAATTGGTAAAGTATTTAGAAATGAAGGTATAGATAATACACATAATCCTGGATTTACTTCGTGTGAATTTTATTGGGCATATGCT	750
KRS14GGG	TATGAAATTGGTAAAGTATTTAGAAATGAAGGTATAGATAATACACATAATCCTGGGTTTACTTCGTGTGAATTTTATTGGGCATATGCT	239
KRS15TTT	TATGAAATTGGTAAAGTATTTAGAAATGAAGGTATAGATAATACACATAATCCTGAATTTACTTCGTGTGAATTTTATTGGGCATATGCT	53004
KRS15TTC	TATGAAATTGGTAAAGTATTTAGAAATGAAGGTATAGATAATACACATAATCCTGAATTCACTTCGTGTGAATTTTATTGGGCATATGCT	474
KRS15TTA	TATGAAATTGGTAAAGTATTTAGAAATGAAGGTATAGATAATACACATAATCCTGAATTAACTTCGTGTGAATTTTATTGGGCATATGCT	2049
KRS15TTG	TATGAAATTGGTAAAGTATTTAGAAATGAAGGTATAGATAATACACATAATCCTGAATTGACTTCGTGTGAATTTTATTGGGCATATGCT	517
KRS15CTT	TATGAAATTGGTAAAGTATTTAGAAATGAAGGTATAGATAATACACATAATCCTGAACTTACTTCGTGTGAATTTTATTGGGCATATGCT	997
KRS15CTC	TATGAAATTGGTAAAGTATTTAGAAATGAAGGTATAGATAATACACATAATCCTGAACTCACTTCGTGTGAATTTTATTGGGCATATGCT	376
KRS15CTA	TATGAAATTGGTAAAGTATTTAGAAATGAAGGTATAGATAATACACATAATCCTGAACTAACTTCGTGTGAATTTTATTGGGCATATGCT	566
KRS15CTG	TATGAAATTGGTAAAGTATTTAGAAATGAAGGTATAGATAATACACATAATCCTGAACTGACTTCGTGTGAATTTTATTGGGCATATGCT	646
KRS15ATT	TATGAAATTGGTAAAGTATTTAGAAATGAAGGTATAGATAATACACATAATCCTGAAATTACTTCGTGTGAATTTTATTGGGCATATGCT	1389
KRS15ATC	TATGAAATTGGTAAAGTATTTAGAAATGAAGGTATAGATAATACACATAATCCTGAAATCACTTCGTGTGAATTTTATTGGGCATATGCT	1385
KRS15ATA	TATGAAATTGGTAAAGTATTTAGAAATGAAGGTATAGATAATACACATAATCCTGAAATAACTTCGTGTGAATTTTATTGGGCATATGCT	1671
KRS15ATG	TATGAAATTGGTAAAGTATTTAGAAATGAAGGTATAGATAATACACATAATCCTGAAATGACTTCGTGTGAATTTTATTGGGCATATGCT	687
KRS15GTT	TATGAAATTGGTAAAGTATTTAGAAATGAAGGTATAGATAATACACATAATCCTGAAGTTACTTCGTGTGAATTTTATTGGGCATATGCT	3411
KRS15GTC	TATGAAATTGGTAAAGTATTTAGAAATGAAGGTATAGATAATACACATAATCCTGAAGTCACTTCGTGTGAATTTTATTGGGCATATGCT	366
KRS15GTA	TATGAAATTGGTAAAGTATTTAGAAATGAAGGTATAGATAATACACATAATCCTGAAGTAACTTCGTGTGAATTTTATTGGGCATATGCT	1194
KRS15GTG	TATGAAATTGGTAAAGTATTTAGAAATGAAGGTATAGATAATACACATAATCCTGAAGTGACTTCGTGTGAATTTTATTGGGCATATGCT	608
KRS15TCT	TATGAAATTGGTAAAGTATTTAGAAATGAAGGTATAGATAATACACATAATCCTGAATCTACTTCGTGTGAATTTTATTGGGCATATGCT	591
KRS15TCC	TATGAAATTGGTAAAGTATTTAGAAATGAAGGTATAGATAATACACATAATCCTGAATCCACTTCGTGTGAATTTTATTGGGCATATGCT	277
KRS15TCA	TATGAAATTGGTAAAGTATTTAGAAATGAAGGTATAGATAATACACATAATCCTGAATCAACTTCGTGTGAATTTTATTGGGCATATGCT	2182
KRS15TCG	TATGAAATTGGTAAAGTATTTAGAAATGAAGGTATAGATAATACACATAATCCTGAATCGACTTCGTGTGAATTTTATTGGGCATATGCT	287
KRS15CCT	TATGAAATTGGTAAAGTATTTAGAAATGAAGGTATAGATAATACACATAATCCTGAACCTACTTCGTGTGAATTTTATTGGGCATATGCT	720
KRS15CCC	TATGAAATTGGTAAAGTATTTAGAAATGAAGGTATAGATAATACACATAATCCTGAACCCACTTCGTGTGAATTTTATTGGGCATATGCT	216
KRS15CCA	TATGAAATTGGTAAAGTATTTAGAAATGAAGGTATAGATAATACACATAATCCTGAACCAACTTCGTGTGAATTTTATTGGGCATATGCT	589
KRS15CCG	TATGAAATTGGTAAAGTATTTAGAAATGAAGGTATAGATAATACACATAATCCTGAACCGACTTCGTGTGAATTTTATTGGGCATATGCT	610
KRS15ACT	TATGAAATTGGTAAAGTATTTAGAAATGAAGGTATAGATAATACACATAATCCTGAAACTACTTCGTGTGAATTTTATTGGGCATATGCT	628
KRS15ACC	TATGAAATTGGTAAAGTATTTAGAAATGAAGGTATAGATAATACACATAATCCTGAAACCACTTCGTGTGAATTTTATTGGGCATATGCT	670
KRS15ACA	TATGAAATTGGTAAAGTATTTAGAAATGAAGGTATAGATAATACACATAATCCTGAAACAACTTCGTGTGAATTTTATTGGGCATATGCT	5451
KRS15ACG	TATGAAATTGGTAAAGTATTTAGAAATGAAGGTATAGATAATACACATAATCCTGAAACGACTTCGTGTGAATTTTATTGGGCATATGCT	824
KRS15GCT	TATGAAATTGGTAAAGTATTTAGAAATGAAGGTATAGATAATACACATAATCCTGAAGCTACTTCGTGTGAATTTTATTGGGCATATGCT	2456
KRS15GCC	TATGAAATTGGTAAAGTATTTAGAAATGAAGGTATAGATAATACACATAATCCTGAAGCCACTTCGTGTGAATTTTATTGGGCATATGCT	316
KRS15GCA	TATGAAATTGGTAAAGTATTTAGAAATGAAGGTATAGATAATACACATAATCCTGAAGCAACTTCGTGTGAATTTTATTGGGCATATGCT	792
KRS15GCG	TATGAAATTGGTAAAGTATTTAGAAATGAAGGTATAGATAATACACATAATCCTGAAGCGACTTCGTGTGAATTTTATTGGGCATATGCT	437
KRS15TAT	TATGAAATTGGTAAAGTATTTAGAAATGAAGGTATAGATAATACACATAATCCTGAATATACTTCGTGTGAATTTTATTGGGCATATGCT	1089
KRS15TAC	TATGAAATTGGTAAAGTATTTAGAAATGAAGGTATAGATAATACACATAATCCTGAATACACTTCGTGTGAATTTTATTGGGCATATGCT	10133
KRS15TAA	TATGAAATTGGTAAAGTATTTAGAAATGAAGGTATAGATAATACACATAATCCTGAATAAACTTCGTGTGAATTTTATTGGGCATATGCT	2619
KRS15TAG	TATGAAATTGGTAAAGTATTTAGAAATGAAGGTATAGATAATACACATAATCCTGAATAGACTTCGTGTGAATTTTATTGGGCATATGCT	701
KRS15CAT	TATGAAATTGGTAAAGTATTTAGAAATGAAGGTATAGATAATACACATAATCCTGAACATACTTCGTGTGAATTTTATTGGGCATATGCT	1694
KRS15CAC	TATGAAATTGGTAAAGTATTTAGAAATGAAGGTATAGATAATACACATAATCCTGAACACACTTCGTGTGAATTTTATTGGGCATATGCT	991
KRS15CAA	TATGAAATTGGTAAAGTATTTAGAAATGAAGGTATAGATAATACACATAATCCTGAACAAACTTCGTGTGAATTTTATTGGGCATATGCT	3893
KRS15CAG	TATGAAATTGGTAAAGTATTTAGAAATGAAGGTATAGATAATACACATAATCCTGAACAGACTTCGTGTGAATTTTATTGGGCATATGCT	1835
KRS15AAT	TATGAAATTGGTAAAGTATTTAGAAATGAAGGTATAGATAATACACATAATCCTGAAAATACTTCGTGTGAATTTTATTGGGCATATGCT	3612
KRS15AAC	TATGAAATTGGTAAAGTATTTAGAAATGAAGGTATAGATAATACACATAATCCTGAAAACACTTCGTGTGAATTTTATTGGGCATATGCT	3186
KRS15AAA	TATGAAATTGGTAAAGTATTTAGAAATGAAGGTATAGATAATACACATAATCCTGAAAAAACTTCGTGTGAATTTTATTGGGCATATGCT	10879
KRS15AAG	TATGAAATTGGTAAAGTATTTAGAAATGAAGGTATAGATAATACACATAATCCTGAAAAGACTTCGTGTGAATTTTATTGGGCATATGCT	1239
KRS15GAT	TATGAAATTGGTAAAGTATTTAGAAATGAAGGTATAGATAATACACATAATCCTGAAGATACTTCGTGTGAATTTTATTGGGCATATGCT	519
KRS15GAC	TATGAAATTGGTAAAGTATTTAGAAATGAAGGTATAGATAATACACATAATCCTGAAGACACTTCGTGTGAATTTTATTGGGCATATGCT	1568
KRS15GAA	TATGAAATTGGTAAAGTATTTAGAAATGAAGGTATAGATAATACACATAATCCTGAAGAAACTTCGTGTGAATTTTATTGGGCATATGCT	3477
KRS15GAG	TATGAAATTGGTAAAGTATTTAGAAATGAAGGTATAGATAATACACATAATCCTGAAGAGACTTCGTGTGAATTTTATTGGGCATATGCT	1233
KRS15TGT	TATGAAATTGGTAAAGTATTTAGAAATGAAGGTATAGATAATACACATAATCCTGAATGTACTTCGTGTGAATTTTATTGGGCATATGCT	1773
KRS15TGC	TATGAAATTGGTAAAGTATTTAGAAATGAAGGTATAGATAATACACATAATCCTGAATGCACTTCGTGTGAATTTTATTGGGCATATGCT	531
KRS15TGA	TATGAAATTGGTAAAGTATTTAGAAATGAAGGTATAGATAATACACATAATCCTGAATGAACTTCGTGTGAATTTTATTGGGCATATGCT	746
KRS15TGG	TATGAAATTGGTAAAGTATTTAGAAATGAAGGTATAGATAATACACATAATCCTGAATGGACTTCGTGTGAATTTTATTGGGCATATGCT	1883
KRS15CGT	TATGAAATTGGTAAAGTATTTAGAAATGAAGGTATAGATAATACACATAATCCTGAACGTACTTCGTGTGAATTTTATTGGGCATATGCT	352
KRS15CGC	TATGAAATTGGTAAAGTATTTAGAAATGAAGGTATAGATAATACACATAATCCTGAACGCACTTCGTGTGAATTTTATTGGGCATATGCT	235
KRS15CGA	TATGAAATTGGTAAAGTATTTAGAAATGAAGGTATAGATAATACACATAATCCTGAACGAACTTCGTGTGAATTTTATTGGGCATATGCT	395
KRS15CGG	TATGAAATTGGTAAAGTATTTAGAAATGAAGGTATAGATAATACACATAATCCTGAACGGACTTCGTGTGAATTTTATTGGGCATATGCT	299
KRS15AGT	TATGAAATTGGTAAAGTATTTAGAAATGAAGGTATAGATAATACACATAATCCTGAAAGTACTTCGTGTGAATTTTATTGGGCATATGCT	844
KRS15AGC	TATGAAATTGGTAAAGTATTTAGAAATGAAGGTATAGATAATACACATAATCCTGAAAGCACTTCGTGTGAATTTTATTGGGCATATGCT	1713
KRS15AGA	TATGAAATTGGTAAAGTATTTAGAAATGAAGGTATAGATAATACACATAATCCTGAAAGAACTTCGTGTGAATTTTATTGGGCATATGCT	3282
KRS15AGG	TATGAAATTGGTAAAGTATTTAGAAATGAAGGTATAGATAATACACATAATCCTGAAAGGACTTCGTGTGAATTTTATTGGGCATATGCT	351
KRS15GGT	TATGAAATTGGTAAAGTATTTAGAAATGAAGGTATAGATAATACACATAATCCTGAAGGTACTTCGTGTGAATTTTATTGGGCATATGCT	1066
KRS15GGC	TATGAAATTGGTAAAGTATTTAGAAATGAAGGTATAGATAATACACATAATCCTGAAGGCACTTCGTGTGAATTTTATTGGGCATATGCT	1794
KRS15GGA	TATGAAATTGGTAAAGTATTTAGAAATGAAGGTATAGATAATACACATAATCCTGAAGGAACTTCGTGTGAATTTTATTGGGCATATGCT	982
KRS15GGG	TATGAAATTGGTAAAGTATTTAGAAATGAAGGTATAGATAATACACATAATCCTGAAGGGACTTCGTGTGAATTTTATTGGGCATATGCT	1184
KRS16TTT	TATGAAATTGGTAAAGTATTTAGAAATGAAGGTATAGATAATACACATAATCCTGAATTTTTTTCGTGTGAATTTTATTGGGCATATGCT	1266
KRS16TTC	TATGAAATTGGTAAAGTATTTAGAAATGAAGGTATAGATAATACACATAATCCTGAATTTTTCTCGTGTGAATTTTATTGGGCATATGCT	660
KRS16TTA	TATGAAATTGGTAAAGTATTTAGAAATGAAGGTATAGATAATACACATAATCCTGAATTTTTATCGTGTGAATTTTATTGGGCATATGCT	1892
KRS16TTG	TATGAAATTGGTAAAGTATTTAGAAATGAAGGTATAGATAATACACATAATCCTGAATTTTTGTCGTGTGAATTTTATTGGGCATATGCT	1638
KRS16CTT	TATGAAATTGGTAAAGTATTTAGAAATGAAGGTATAGATAATACACATAATCCTGAATTTCTTTCGTGTGAATTTTATTGGGCATATGCT	441
KRS16CTC	TATGAAATTGGTAAAGTATTTAGAAATGAAGGTATAGATAATACACATAATCCTGAATTTCTCTCGTGTGAATTTTATTGGGCATATGCT	308
KRS16CTA	TATGAAATTGGTAAAGTATTTAGAAATGAAGGTATAGATAATACACATAATCCTGAATTTCTATCGTGTGAATTTTATTGGGCATATGCT	651
KRS16CTG	TATGAAATTGGTAAAGTATTTAGAAATGAAGGTATAGATAATACACATAATCCTGAATTTCTGTCGTGTGAATTTTATTGGGCATATGCT	532
KRS16ATT	TATGAAATTGGTAAAGTATTTAGAAATGAAGGTATAGATAATACACATAATCCTGAATTTATTTCGTGTGAATTTTATTGGGCATATGCT	725
KRS16ATC	TATGAAATTGGTAAAGTATTTAGAAATGAAGGTATAGATAATACACATAATCCTGAATTTATCTCGTGTGAATTTTATTGGGCATATGCT	1036
KRS16ATA	TATGAAATTGGTAAAGTATTTAGAAATGAAGGTATAGATAATACACATAATCCTGAATTTATATCGTGTGAATTTTATTGGGCATATGCT	3204
KRS16ATG	TATGAAATTGGTAAAGTATTTAGAAATGAAGGTATAGATAATACACATAATCCTGAATTTATGTCGTGTGAATTTTATTGGGCATATGCT	2238
KRS16GTT	TATGAAATTGGTAAAGTATTTAGAAATGAAGGTATAGATAATACACATAATCCTGAATTTGTTTCGTGTGAATTTTATTGGGCATATGCT	1255
KRS16GTC	TATGAAATTGGTAAAGTATTTAGAAATGAAGGTATAGATAATACACATAATCCTGAATTTGTCTCGTGTGAATTTTATTGGGCATATGCT	375
KRS16GTA	TATGAAATTGGTAAAGTATTTAGAAATGAAGGTATAGATAATACACATAATCCTGAATTTGTATCGTGTGAATTTTATTGGGCATATGCT	932
KRS16GTG	TATGAAATTGGTAAAGTATTTAGAAATGAAGGTATAGATAATACACATAATCCTGAATTTGTGTCGTGTGAATTTTATTGGGCATATGCT	2570
KRS16TCT	TATGAAATTGGTAAAGTATTTAGAAATGAAGGTATAGATAATACACATAATCCTGAATTTTCTTCGTGTGAATTTTATTGGGCATATGCT	2339
KRS16TCC	TATGAAATTGGTAAAGTATTTAGAAATGAAGGTATAGATAATACACATAATCCTGAATTTTCCTCGTGTGAATTTTATTGGGCATATGCT	340
KRS16TCA	TATGAAATTGGTAAAGTATTTAGAAATGAAGGTATAGATAATACACATAATCCTGAATTTTCATCGTGTGAATTTTATTGGGCATATGCT	1506
KRS16TCG	TATGAAATTGGTAAAGTATTTAGAAATGAAGGTATAGATAATACACATAATCCTGAATTTTCGTCGTGTGAATTTTATTGGGCATATGCT	199
KRS16CCT	TATGAAATTGGTAAAGTATTTAGAAATGAAGGTATAGATAATACACATAATCCTGAATTTCCTTCGTGTGAATTTTATTGGGCATATGCT	450
KRS16CCC	TATGAAATTGGTAAAGTATTTAGAAATGAAGGTATAGATAATACACATAATCCTGAATTTCCCTCGTGTGAATTTTATTGGGCATATGCT	229
KRS16CCA	TATGAAATTGGTAAAGTATTTAGAAATGAAGGTATAGATAATACACATAATCCTGAATTTCCATCGTGTGAATTTTATTGGGCATATGCT	847
KRS16CCG	TATGAAATTGGTAAAGTATTTAGAAATGAAGGTATAGATAATACACATAATCCTGAATTTCCGTCGTGTGAATTTTATTGGGCATATGCT	191
KRS16ACT	TATGAAATTGGTAAAGTATTTAGAAATGAAGGTATAGATAATACACATAATCCTGAATTTACTTCGTGTGAATTTTATTGGGCATATGCT	53004
KRS16ACC	TATGAAATTGGTAAAGTATTTAGAAATGAAGGTATAGATAATACACATAATCCTGAATTTACCTCGTGTGAATTTTATTGGGCATATGCT	820
KRS16ACA	TATGAAATTGGTAAAGTATTTAGAAATGAAGGTATAGATAATACACATAATCCTGAATTTACATCGTGTGAATTTTATTGGGCATATGCT	2568
KRS16ACG	TATGAAATTGGTAAAGTATTTAGAAATGAAGGTATAGATAATACACATAATCCTGAATTTACGTCGTGTGAATTTTATTGGGCATATGCT	425
KRS16GCT	TATGAAATTGGTAAAGTATTTAGAAATGAAGGTATAGATAATACACATAATCCTGAATTTGCTTCGTGTGAATTTTATTGGGCATATGCT	438
KRS16GCC	TATGAAATTGGTAAAGTATTTAGAAATGAAGGTATAGATAATACACATAATCCTGAATTTGCCTCGTGTGAATTTTATTGGGCATATGCT	240
KRS16GCA	TATGAAATTGGTAAAGTATTTAGAAATGAAGGTATAGATAATACACATAATCCTGAATTTGCATCGTGTGAATTTTATTGGGCATATGCT	859
KRS16GCG	TATGAAATTGGTAAAGTATTTAGAAATGAAGGTATAGATAATACACATAATCCTGAATTTGCGTCGTGTGAATTTTATTGGGCATATGCT	718
KRS16TAT	TATGAAATTGGTAAAGTATTTAGAAATGAAGGTATAGATAATACACATAATCCTGAATTTTATTCGTGTGAATTTTATTGGGCATATGCT	1446
KRS16TAC	TATGAAATTGGTAAAGTATTTAGAAATGAAGGTATAGATAATACACATAATCCTGAATTTTACTCGTGTGAATTTTATTGGGCATATGCT	1809
KRS16TAA	TATGAAATTGGTAAAGTATTTAGAAATGAAGGTATAGATAATACACATAATCCTGAATTTTAATCGTGTGAATTTTATTGGGCATATGCT	3942
KRS16TAG	TATGAAATTGGTAAAGTATTTAGAAATGAAGGTATAGATAATACACATAATCCTGAATTTTAGTCGTGTGAATTTTATTGGGCATATGCT	1660
KRS16CAT	TATGAAATTGGTAAAGTATTTAGAAATGAAGGTATAGATAATACACATAATCCTGAATTTCATTCGTGTGAATTTTATTGGGCATATGCT	1122
KRS16CAC	TATGAAATTGGTAAAGTATTTAGAAATGAAGGTATAGATAATACACATAATCCTGAATTTCACTCGTGTGAATTTTATTGGGCATATGCT	564
KRS16CAA	TATGAAATTGGTAAAGTATTTAGAAATGAAGGTATAGATAATACACATAATCCTGAATTTCAATCGTGTGAATTTTATTGGGCATATGCT	1940
KRS16CAG	TATGAAATTGGTAAAGTATTTAGAAATGAAGGTATAGATAATACACATAATCCTGAATTTCAGTCGTGTGAATTTTATTGGGCATATGCT	529
KRS16AAT	TATGAAATTGGTAAAGTATTTAGAAATGAAGGTATAGATAATACACATAATCCTGAATTTAATTCGTGTGAATTTTATTGGGCATATGCT	2024
KRS16AAC	TATGAAATTGGTAAAGTATTTAGAAATGAAGGTATAGATAATACACATAATCCTGAATTTAACTCGTGTGAATTTTATTGGGCATATGCT	1985
KRS16AAA	TATGAAATTGGTAAAGTATTTAGAAATGAAGGTATAGATAATACACATAATCCTGAATTTAAATCGTGTGAATTTTATTGGGCATATGCT	18488
KRS16AAG	TATGAAATTGGTAAAGTATTTAGAAATGAAGGTATAGATAATACACATAATCCTGAATTTAAGTCGTGTGAATTTTATTGGGCATATGCT	1849
KRS16GAT	TATGAAATTGGTAAAGTATTTAGAAATGAAGGTATAGATAATACACATAATCCTGAATTTGATTCGTGTGAATTTTATTGGGCATATGCT	619
KRS16GAC	TATGAAATTGGTAAAGTATTTAGAAATGAAGGTATAGATAATACACATAATCCTGAATTTGACTCGTGTGAATTTTATTGGGCATATGCT	458
KRS16GAA	TATGAAATTGGTAAAGTATTTAGAAATGAAGGTATAGATAATACACATAATCCTGAATTTGAATCGTGTGAATTTTATTGGGCATATGCT	2443
KRS16GAG	TATGAAATTGGTAAAGTATTTAGAAATGAAGGTATAGATAATACACATAATCCTGAATTTGAGTCGTGTGAATTTTATTGGGCATATGCT	450
KRS16TGT	TATGAAATTGGTAAAGTATTTAGAAATGAAGGTATAGATAATACACATAATCCTGAATTTTGTTCGTGTGAATTTTATTGGGCATATGCT	3076
KRS16TGC	TATGAAATTGGTAAAGTATTTAGAAATGAAGGTATAGATAATACACATAATCCTGAATTTTGCTCGTGTGAATTTTATTGGGCATATGCT	1150
KRS16TGA	TATGAAATTGGTAAAGTATTTAGAAATGAAGGTATAGATAATACACATAATCCTGAATTTTGATCGTGTGAATTTTATTGGGCATATGCT	987
KRS16TGG	TATGAAATTGGTAAAGTATTTAGAAATGAAGGTATAGATAATACACATAATCCTGAATTTTGGTCGTGTGAATTTTATTGGGCATATGCT	664
KRS16CGT	TATGAAATTGGTAAAGTATTTAGAAATGAAGGTATAGATAATACACATAATCCTGAATTTCGTTCGTGTGAATTTTATTGGGCATATGCT	370
KRS16CGC	TATGAAATTGGTAAAGTATTTAGAAATGAAGGTATAGATAATACACATAATCCTGAATTTCGCTCGTGTGAATTTTATTGGGCATATGCT	181
KRS16CGA	TATGAAATTGGTAAAGTATTTAGAAATGAAGGTATAGATAATACACATAATCCTGAATTTCGATCGTGTGAATTTTATTGGGCATATGCT	2503
KRS16CGG	TATGAAATTGGTAAAGTATTTAGAAATGAAGGTATAGATAATACACATAATCCTGAATTTCGGTCGTGTGAATTTTATTGGGCATATGCT	648
KRS16AGT	TATGAAATTGGTAAAGTATTTAGAAATGAAGGTATAGATAATACACATAATCCTGAATTTAGTTCGTGTGAATTTTATTGGGCATATGCT	2612
KRS16AGC	TATGAAATTGGTAAAGTATTTAGAAATGAAGGTATAGATAATACACATAATCCTGAATTTAGCTCGTGTGAATTTTATTGGGCATATGCT	1201
KRS16AGA	TATGAAATTGGTAAAGTATTTAGAAATGAAGGTATAGATAATACACATAATCCTGAATTTAGATCGTGTGAATTTTATTGGGCATATGCT	734
KRS16AGG	TATGAAATTGGTAAAGTATTTAGAAATGAAGGTATAGATAATACACATAATCCTGAATTTAGGTCGTGTGAATTTTATTGGGCATATGCT	2520
KRS16GGT	TATGAAATTGGTAAAGTATTTAGAAATGAAGGTATAGATAATACACATAATCCTGAATTTGGTTCGTGTGAATTTTATTGGGCATATGCT	780
KRS16GGC	TATGAAATTGGTAAAGTATTTAGAAATGAAGGTATAGATAATACACATAATCCTGAATTTGGCTCGTGTGAATTTTATTGGGCATATGCT	348
KRS16GGA	TATGAAATTGGTAAAGTATTTAGAAATGAAGGTATAGATAATACACATAATCCTGAATTTGGATCGTGTGAATTTTATTGGGCATATGCT	1100
KRS16GGG	TATGAAATTGGTAAAGTATTTAGAAATGAAGGTATAGATAATACACATAATCCTGAATTTGGGTCGTGTGAATTTTATTGGGCATATGCT	465
KRS17TTT	TATGAAATTGGTAAAGTATTTAGAAATGAAGGTATAGATAATACACATAATCCTGAATTTACTTTTTGTGAATTTTATTGGGCATATGCT	3677
KRS17TTC	TATGAAATTGGTAAAGTATTTAGAAATGAAGGTATAGATAATACACATAATCCTGAATTTACTTTCTGTGAATTTTATTGGGCATATGCT	2236
KRS17TTA	TATGAAATTGGTAAAGTATTTAGAAATGAAGGTATAGATAATACACATAATCCTGAATTTACTTTATGTGAATTTTATTGGGCATATGCT	4127
KRS17TTG	TATGAAATTGGTAAAGTATTTAGAAATGAAGGTATAGATAATACACATAATCCTGAATTTACTTTGTGTGAATTTTATTGGGCATATGCT	1837
KRS17CTT	TATGAAATTGGTAAAGTATTTAGAAATGAAGGTATAGATAATACACATAATCCTGAATTTACTCTTTGTGAATTTTATTGGGCATATGCT	2033
KRS17CTC	TATGAAATTGGTAAAGTATTTAGAAATGAAGGTATAGATAATACACATAATCCTGAATTTACTCTCTGTGAATTTTATTGGGCATATGCT	917
KRS17CTA	TATGAAATTGGTAAAGTATTTAGAAATGAAGGTATAGATAATACACATAATCCTGAATTTACTCTATGTGAATTTTATTGGGCATATGCT	1747
KRS17CTG	TATGAAATTGGTAAAGTATTTAGAAATGAAGGTATAGATAATACACATAATCCTGAATTTACTCTGTGTGAATTTTATTGGGCATATGCT	1206
KRS17ATT	TATGAAATTGGTAAAGTATTTAGAAATGAAGGTATAGATAATACACATAATCCTGAATTTACTATTTGTGAATTTTATTGGGCATATGCT	13120
KRS17ATC	TATGAAATTGGTAAAGTATTTAGAAATGAAGGTATAGATAATACACATAATCCTGAATTTACTATCTGTGAATTTTATTGGGCATATGCT	1769
KRS17ATA	TATGAAATTGGTAAAGTATTTAGAAATGAAGGTATAGATAATACACATAATCCTGAATTTACTATATGTGAATTTTATTGGGCATATGCT	5926
KRS17ATG	TATGAAATTGGTAAAGTATTTAGAAATGAAGGTATAGATAATACACATAATCCTGAATTTACTATGTGTGAATTTTATTGGGCATATGCT	2374
KRS17GTT	TATGAAATTGGTAAAGTATTTAGAAATGAAGGTATAGATAATACACATAATCCTGAATTTACTGTTTGTGAATTTTATTGGGCATATGCT	2293
KRS17GTC	TATGAAATTGGTAAAGTATTTAGAAATGAAGGTATAGATAATACACATAATCCTGAATTTACTGTCTGTGAATTTTATTGGGCATATGCT	891
KRS17GTA	TATGAAATTGGTAAAGTATTTAGAAATGAAGGTATAGATAATACACATAATCCTGAATTTACTGTATGTGAATTTTATTGGGCATATGCT	1285
KRS17GTG	TATGAAATTGGTAAAGTATTTAGAAATGAAGGTATAGATAATACACATAATCCTGAATTTACTGTGTGTGAATTTTATTGGGCATATGCT	3831
KRS17TCT	TATGAAATTGGTAAAGTATTTAGAAATGAAGGTATAGATAATACACATAATCCTGAATTTACTTCTTGTGAATTTTATTGGGCATATGCT	1147
KRS17TCC	TATGAAATTGGTAAAGTATTTAGAAATGAAGGTATAGATAATACACATAATCCTGAATTTACTTCCTGTGAATTTTATTGGGCATATGCT	558
KRS17TCA	TATGAAATTGGTAAAGTATTTAGAAATGAAGGTATAGATAATACACATAATCCTGAATTTACTTCATGTGAATTTTATTGGGCATATGCT	1881
KRS17TCG	TATGAAATTGGTAAAGTATTTAGAAATGAAGGTATAGATAATACACATAATCCTGAATTTACTTCGTGTGAATTTTATTGGGCATATGCT	53004
KRS17CCT	TATGAAATTGGTAAAGTATTTAGAAATGAAGGTATAGATAATACACATAATCCTGAATTTACTCCTTGTGAATTTTATTGGGCATATGCT	911
KRS17CCC	TATGAAATTGGTAAAGTATTTAGAAATGAAGGTATAGATAATACACATAATCCTGAATTTACTCCCTGTGAATTTTATTGGGCATATGCT	1149
KRS17CCA	TATGAAATTGGTAAAGTATTTAGAAATGAAGGTATAGATAATACACATAATCCTGAATTTACTCCATGTGAATTTTATTGGGCATATGCT	1024
KRS17CCG	TATGAAATTGGTAAAGTATTTAGAAATGAAGGTATAGATAATACACATAATCCTGAATTTACTCCGTGTGAATTTTATTGGGCATATGCT	548
KRS17ACT	TATGAAATTGGTAAAGTATTTAGAAATGAAGGTATAGATAATACACATAATCCTGAATTTACTACTTGTGAATTTTATTGGGCATATGCT	4110
KRS17ACC	TATGAAATTGGTAAAGTATTTAGAAATGAAGGTATAGATAATACACATAATCCTGAATTTACTACCTGTGAATTTTATTGGGCATATGCT	642
KRS17ACA	TATGAAATTGGTAAAGTATTTAGAAATGAAGGTATAGATAATACACATAATCCTGAATTTACTACATGTGAATTTTATTGGGCATATGCT	3410
KRS17ACG	TATGAAATTGGTAAAGTATTTAGAAATGAAGGTATAGATAATACACATAATCCTGAATTTACTACGTGTGAATTTTATTGGGCATATGCT	667
KRS17GCT	TATGAAATTGGTAAAGTATTTAGAAATGAAGGTATAGATAATACACATAATCCTGAATTTACTGCTTGTGAATTTTATTGGGCATATGCT	1148
KRS17GCC	TATGAAATTGGTAAAGTATTTAGAAATGAAGGTATAGATAATACACATAATCCTGAATTTACTGCCTGTGAATTTTATTGGGCATATGCT	256
KRS17GCA	TATGAAATTGGTAAAGTATTTAGAAATGAAGGTATAGATAATACACATAATCCTGAATTTACTGCATGTGAATTTTATTGGGCATATGCT	2278
KRS17GCG	TATGAAATTGGTAAAGTATTTAGAAATGAAGGTATAGATAATACACATAATCCTGAATTTACTGCGTGTGAATTTTATTGGGCATATGCT	642
KRS17TAT	TATGAAATTGGTAAAGTATTTAGAAATGAAGGTATAGATAATACACATAATCCTGAATTTACTTATTGTGAATTTTATTGGGCATATGCT	2286
KRS17TAC	TATGAAATTGGTAAAGTATTTAGAAATGAAGGTATAGATAATACACATAATCCTGAATTTACTTACTGTGAATTTTATTGGGCATATGCT	2327
KRS17TAA	TATGAAATTGGTAAAGTATTTAGAAATGAAGGTATAGATAATACACATAATCCTGAATTTACTTAATGTGAATTTTATTGGGCATATGCT	3168
KRS17TAG	TATGAAATTGGTAAAGTATTTAGAAATGAAGGTATAGATAATACACATAATCCTGAATTTACTTAGTGTGAATTTTATTGGGCATATGCT	1718
KRS17CAT	TATGAAATTGGTAAAGTATTTAGAAATGAAGGTATAGATAATACACATAATCCTGAATTTACTCATTGTGAATTTTATTGGGCATATGCT	1869
KRS17CAC	TATGAAATTGGTAAAGTATTTAGAAATGAAGGTATAGATAATACACATAATCCTGAATTTACTCACTGTGAATTTTATTGGGCATATGCT	1452
KRS17CAA	TATGAAATTGGTAAAGTATTTAGAAATGAAGGTATAGATAATACACATAATCCTGAATTTACTCAATGTGAATTTTATTGGGCATATGCT	4821
KRS17CAG	TATGAAATTGGTAAAGTATTTAGAAATGAAGGTATAGATAATACACATAATCCTGAATTTACTCAGTGTGAATTTTATTGGGCATATGCT	2345
KRS17AAT	TATGAAATTGGTAAAGTATTTAGAAATGAAGGTATAGATAATACACATAATCCTGAATTTACTAATTGTGAATTTTATTGGGCATATGCT	3521
KRS17AAC	TATGAAATTGGTAAAGTATTTAGAAATGAAGGTATAGATAATACACATAATCCTGAATTTACTAACTGTGAATTTTATTGGGCATATGCT	3632
KRS17AAA	TATGAAATTGGTAAAGTATTTAGAAATGAAGGTATAGATAATACACATAATCCTGAATTTACTAAATGTGAATTTTATTGGGCATATGCT	13252
KRS17AAG	TATGAAATTGGTAAAGTATTTAGAAATGAAGGTATAGATAATACACATAATCCTGAATTTACTAAGTGTGAATTTTATTGGGCATATGCT	1314
KRS17GAT	TATGAAATTGGTAAAGTATTTAGAAATGAAGGTATAGATAATACACATAATCCTGAATTTACTGATTGTGAATTTTATTGGGCATATGCT	754
KRS17GAC	TATGAAATTGGTAAAGTATTTAGAAATGAAGGTATAGATAATACACATAATCCTGAATTTACTGACTGTGAATTTTATTGGGCATATGCT	699
KRS17GAA	TATGAAATTGGTAAAGTATTTAGAAATGAAGGTATAGATAATACACATAATCCTGAATTTACTGAATGTGAATTTTATTGGGCATATGCT	1503
KRS17GAG	TATGAAATTGGTAAAGTATTTAGAAATGAAGGTATAGATAATACACATAATCCTGAATTTACTGAGTGTGAATTTTATTGGGCATATGCT	557
KRS17TGT	TATGAAATTGGTAAAGTATTTAGAAATGAAGGTATAGATAATACACATAATCCTGAATTTACTTGTTGTGAATTTTATTGGGCATATGCT	2071
KRS17TGC	TATGAAATTGGTAAAGTATTTAGAAATGAAGGTATAGATAATACACATAATCCTGAATTTACTTGCTGTGAATTTTATTGGGCATATGCT	861
KRS17TGA	TATGAAATTGGTAAAGTATTTAGAAATGAAGGTATAGATAATACACATAATCCTGAATTTACTTGATGTGAATTTTATTGGGCATATGCT	1147
KRS17TGG	TATGAAATTGGTAAAGTATTTAGAAATGAAGGTATAGATAATACACATAATCCTGAATTTACTTGGTGTGAATTTTATTGGGCATATGCT	696
KRS17CGT	TATGAAATTGGTAAAGTATTTAGAAATGAAGGTATAGATAATACACATAATCCTGAATTTACTCGTTGTGAATTTTATTGGGCATATGCT	798
KRS17CGC	TATGAAATTGGTAAAGTATTTAGAAATGAAGGTATAGATAATACACATAATCCTGAATTTACTCGCTGTGAATTTTATTGGGCATATGCT	332
KRS17CGA	TATGAAATTGGTAAAGTATTTAGAAATGAAGGTATAGATAATACACATAATCCTGAATTTACTCGATGTGAATTTTATTGGGCATATGCT	474
KRS17CGG	TATGAAATTGGTAAAGTATTTAGAAATGAAGGTATAGATAATACACATAATCCTGAATTTACTCGGTGTGAATTTTATTGGGCATATGCT	472
KRS17AGT	TATGAAATTGGTAAAGTATTTAGAAATGAAGGTATAGATAATACACATAATCCTGAATTTACTAGTTGTGAATTTTATTGGGCATATGCT	1010
KRS17AGC	TATGAAATTGGTAAAGTATTTAGAAATGAAGGTATAGATAATACACATAATCCTGAATTTACTAGCTGTGAATTTTATTGGGCATATGCT	937
KRS17AGA	TATGAAATTGGTAAAGTATTTAGAAATGAAGGTATAGATAATACACATAATCCTGAATTTACTAGATGTGAATTTTATTGGGCATATGCT	1485
KRS17AGG	TATGAAATTGGTAAAGTATTTAGAAATGAAGGTATAGATAATACACATAATCCTGAATTTACTAGGTGTGAATTTTATTGGGCATATGCT	426
KRS17GGT	TATGAAATTGGTAAAGTATTTAGAAATGAAGGTATAGATAATACACATAATCCTGAATTTACTGGTTGTGAATTTTATTGGGCATATGCT	1204
KRS17GGC	TATGAAATTGGTAAAGTATTTAGAAATGAAGGTATAGATAATACACATAATCCTGAATTTACTGGCTGTGAATTTTATTGGGCATATGCT	3470
KRS17GGA	TATGAAATTGGTAAAGTATTTAGAAATGAAGGTATAGATAATACACATAATCCTGAATTTACTGGATGTGAATTTTATTGGGCATATGCT	356
KRS17GGG	TATGAAATTGGTAAAGTATTTAGAAATGAAGGTATAGATAATACACATAATCCTGAATTTACTGGGTGTGAATTTTATTGGGCATATGCT	404
KRS18TTT	TATGAAATTGGTAAAGTATTTAGAAATGAAGGTATAGATAATACACATAATCCTGAATTTACTTCGTTTGAATTTTATTGGGCATATGCT	2521
KRS18TTC	TATGAAATTGGTAAAGTATTTAGAAATGAAGGTATAGATAATACACATAATCCTGAATTTACTTCGTTCGAATTTTATTGGGCATATGCT	871
KRS18TTA	TATGAAATTGGTAAAGTATTTAGAAATGAAGGTATAGATAATACACATAATCCTGAATTTACTTCGTTAGAATTTTATTGGGCATATGCT	3062
KRS18TTG	TATGAAATTGGTAAAGTATTTAGAAATGAAGGTATAGATAATACACATAATCCTGAATTTACTTCGTTGGAATTTTATTGGGCATATGCT	2017
KRS18CTT	TATGAAATTGGTAAAGTATTTAGAAATGAAGGTATAGATAATACACATAATCCTGAATTTACTTCGCTTGAATTTTATTGGGCATATGCT	653
KRS18CTC	TATGAAATTGGTAAAGTATTTAGAAATGAAGGTATAGATAATACACATAATCCTGAATTTACTTCGCTCGAATTTTATTGGGCATATGCT	369
KRS18CTA	TATGAAATTGGTAAAGTATTTAGAAATGAAGGTATAGATAATACACATAATCCTGAATTTACTTCGCTAGAATTTTATTGGGCATATGCT	1141
KRS18CTG	TATGAAATTGGTAAAGTATTTAGAAATGAAGGTATAGATAATACACATAATCCTGAATTTACTTCGCTGGAATTTTATTGGGCATATGCT	1073
KRS18ATT	TATGAAATTGGTAAAGTATTTAGAAATGAAGGTATAGATAATACACATAATCCTGAATTTACTTCGATTGAATTTTATTGGGCATATGCT	3866
KRS18ATC	TATGAAATTGGTAAAGTATTTAGAAATGAAGGTATAGATAATACACATAATCCTGAATTTACTTCGATCGAATTTTATTGGGCATATGCT	592
KRS18ATA	TATGAAATTGGTAAAGTATTTAGAAATGAAGGTATAGATAATACACATAATCCTGAATTTACTTCGATAGAATTTTATTGGGCATATGCT	3234
KRS18ATG	TATGAAATTGGTAAAGTATTTAGAAATGAAGGTATAGATAATACACATAATCCTGAATTTACTTCGATGGAATTTTATTGGGCATATGCT	1445
KRS18GTT	TATGAAATTGGTAAAGTATTTAGAAATGAAGGTATAGATAATACACATAATCCTGAATTTACTTCGGTTGAATTTTATTGGGCATATGCT	720
KRS18GTC	TATGAAATTGGTAAAGTATTTAGAAATGAAGGTATAGATAATACACATAATCCTGAATTTACTTCGGTCGAATTTTATTGGGCATATGCT	308
KRS18GTA	TATGAAATTGGTAAAGTATTTAGAAATGAAGGTATAGATAATACACATAATCCTGAATTTACTTCGGTAGAATTTTATTGGGCATATGCT	1009
KRS18GTG	TATGAAATTGGTAAAGTATTTAGAAATGAAGGTATAGATAATACACATAATCCTGAATTTACTTCGGTGGAATTTTATTGGGCATATGCT	1146
KRS18TCT	TATGAAATTGGTAAAGTATTTAGAAATGAAGGTATAGATAATACACATAATCCTGAATTTACTTCGTCTGAATTTTATTGGGCATATGCT	714
KRS18TCC	TATGAAATTGGTAAAGTATTTAGAAATGAAGGTATAGATAATACACATAATCCTGAATTTACTTCGTCCGAATTTTATTGGGCATATGCT	268
KRS18TCA	TATGAAATTGGTAAAGTATTTAGAAATGAAGGTATAGATAATACACATAATCCTGAATTTACTTCGTCAGAATTTTATTGGGCATATGCT	614
KRS18TCG	TATGAAATTGGTAAAGTATTTAGAAATGAAGGTATAGATAATACACATAATCCTGAATTTACTTCGTCGGAATTTTATTGGGCATATGCT	727
KRS18CCT	TATGAAATTGGTAAAGTATTTAGAAATGAAGGTATAGATAATACACATAATCCTGAATTTACTTCGCCTGAATTTTATTGGGCATATGCT	307
KRS18CCC	TATGAAATTGGTAAAGTATTTAGAAATGAAGGTATAGATAATACACATAATCCTGAATTTACTTCGCCCGAATTTTATTGGGCATATGCT	93
KRS18CCA	TATGAAATTGGTAAAGTATTTAGAAATGAAGGTATAGATAATACACATAATCCTGAATTTACTTCGCCAGAATTTTATTGGGCATATGCT	481
KRS18CCG	TATGAAATTGGTAAAGTATTTAGAAATGAAGGTATAGATAATACACATAATCCTGAATTTACTTCGCCGGAATTTTATTGGGCATATGCT	322
KRS18ACT	TATGAAATTGGTAAAGTATTTAGAAATGAAGGTATAGATAATACACATAATCCTGAATTTACTTCGACTGAATTTTATTGGGCATATGCT	327
KRS18ACC	TATGAAATTGGTAAAGTATTTAGAAATGAAGGTATAGATAATACACATAATCCTGAATTTACTTCGACCGAATTTTATTGGGCATATGCT	258
KRS18ACA	TATGAAATTGGTAAAGTATTTAGAAATGAAGGTATAGATAATACACATAATCCTGAATTTACTTCGACAGAATTTTATTGGGCATATGCT	1647
KRS18ACG	TATGAAATTGGTAAAGTATTTAGAAATGAAGGTATAGATAATACACATAATCCTGAATTTACTTCGACGGAATTTTATTGGGCATATGCT	451
KRS18GCT	TATGAAATTGGTAAAGTATTTAGAAATGAAGGTATAGATAATACACATAATCCTGAATTTACTTCGGCTGAATTTTATTGGGCATATGCT	518
KRS18GCC	TATGAAATTGGTAAAGTATTTAGAAATGAAGGTATAGATAATACACATAATCCTGAATTTACTTCGGCCGAATTTTATTGGGCATATGCT	306
KRS18GCA	TATGAAATTGGTAAAGTATTTAGAAATGAAGGTATAGATAATACACATAATCCTGAATTTACTTCGGCAGAATTTTATTGGGCATATGCT	422
KRS18GCG	TATGAAATTGGTAAAGTATTTAGAAATGAAGGTATAGATAATACACATAATCCTGAATTTACTTCGGCGGAATTTTATTGGGCATATGCT	509
KRS18TAT	TATGAAATTGGTAAAGTATTTAGAAATGAAGGTATAGATAATACACATAATCCTGAATTTACTTCGTATGAATTTTATTGGGCATATGCT	836
KRS18TAC	TATGAAATTGGTAAAGTATTTAGAAATGAAGGTATAGATAATACACATAATCCTGAATTTACTTCGTACGAATTTTATTGGGCATATGCT	711
KRS18TAA	TATGAAATTGGTAAAGTATTTAGAAATGAAGGTATAGATAATACACATAATCCTGAATTTACTTCGTAAGAATTTTATTGGGCATATGCT	1864
KRS18TAG	TATGAAATTGGTAAAGTATTTAGAAATGAAGGTATAGATAATACACATAATCCTGAATTTACTTCGTAGGAATTTTATTGGGCATATGCT	1130
KRS18CAT	TATGAAATTGGTAAAGTATTTAGAAATGAAGGTATAGATAATACACATAATCCTGAATTTACTTCGCATGAATTTTATTGGGCATATGCT	1002
KRS18CAC	TATGAAATTGGTAAAGTATTTAGAAATGAAGGTATAGATAATACACATAATCCTGAATTTACTTCGCACGAATTTTATTGGGCATATGCT	594
KRS18CAA	TATGAAATTGGTAAAGTATTTAGAAATGAAGGTATAGATAATACACATAATCCTGAATTTACTTCGCAAGAATTTTATTGGGCATATGCT	3595
KRS18CAG	TATGAAATTGGTAAAGTATTTAGAAATGAAGGTATAGATAATACACATAATCCTGAATTTACTTCGCAGGAATTTTATTGGGCATATGCT	1156
KRS18AAT	TATGAAATTGGTAAAGTATTTAGAAATGAAGGTATAGATAATACACATAATCCTGAATTTACTTCGAATGAATTTTATTGGGCATATGCT	2094
KRS18AAC	TATGAAATTGGTAAAGTATTTAGAAATGAAGGTATAGATAATACACATAATCCTGAATTTACTTCGAACGAATTTTATTGGGCATATGCT	2420
KRS18AAA	TATGAAATTGGTAAAGTATTTAGAAATGAAGGTATAGATAATACACATAATCCTGAATTTACTTCGAAAGAATTTTATTGGGCATATGCT	10869
KRS18AAG	TATGAAATTGGTAAAGTATTTAGAAATGAAGGTATAGATAATACACATAATCCTGAATTTACTTCGAAGGAATTTTATTGGGCATATGCT	1064
KRS18GAT	TATGAAATTGGTAAAGTATTTAGAAATGAAGGTATAGATAATACACATAATCCTGAATTTACTTCGGATGAATTTTATTGGGCATATGCT	852
KRS18GAC	TATGAAATTGGTAAAGTATTTAGAAATGAAGGTATAGATAATACACATAATCCTGAATTTACTTCGGACGAATTTTATTGGGCATATGCT	275
KRS18GAA	TATGAAATTGGTAAAGTATTTAGAAATGAAGGTATAGATAATACACATAATCCTGAATTTACTTCGGAAGAATTTTATTGGGCATATGCT	1014
KRS18GAG	TATGAAATTGGTAAAGTATTTAGAAATGAAGGTATAGATAATACACATAATCCTGAATTTACTTCGGAGGAATTTTATTGGGCATATGCT	654
KRS18TGT	TATGAAATTGGTAAAGTATTTAGAAATGAAGGTATAGATAATACACATAATCCTGAATTTACTTCGTGTGAATTTTATTGGGCATATGCT	53004
KRS18TGC	TATGAAATTGGTAAAGTATTTAGAAATGAAGGTATAGATAATACACATAATCCTGAATTTACTTCGTGCGAATTTTATTGGGCATATGCT	913
KRS18TGA	TATGAAATTGGTAAAGTATTTAGAAATGAAGGTATAGATAATACACATAATCCTGAATTTACTTCGTGAGAATTTTATTGGGCATATGCT	1065
KRS18TGG	TATGAAATTGGTAAAGTATTTAGAAATGAAGGTATAGATAATACACATAATCCTGAATTTACTTCGTGGGAATTTTATTGGGCATATGCT	2744
KRS18CGT	TATGAAATTGGTAAAGTATTTAGAAATGAAGGTATAGATAATACACATAATCCTGAATTTACTTCGCGTGAATTTTATTGGGCATATGCT	425
KRS18CGC	TATGAAATTGGTAAAGTATTTAGAAATGAAGGTATAGATAATACACATAATCCTGAATTTACTTCGCGCGAATTTTATTGGGCATATGCT	416
KRS18CGA	TATGAAATTGGTAAAGTATTTAGAAATGAAGGTATAGATAATACACATAATCCTGAATTTACTTCGCGAGAATTTTATTGGGCATATGCT	351
KRS18CGG	TATGAAATTGGTAAAGTATTTAGAAATGAAGGTATAGATAATACACATAATCCTGAATTTACTTCGCGGGAATTTTATTGGGCATATGCT	246
KRS18AGT	TATGAAATTGGTAAAGTATTTAGAAATGAAGGTATAGATAATACACATAATCCTGAATTTACTTCGAGTGAATTTTATTGGGCATATGCT	665
KRS18AGC	TATGAAATTGGTAAAGTATTTAGAAATGAAGGTATAGATAATACACATAATCCTGAATTTACTTCGAGCGAATTTTATTGGGCATATGCT	189
KRS18AGA	TATGAAATTGGTAAAGTATTTAGAAATGAAGGTATAGATAATACACATAATCCTGAATTTACTTCGAGAGAATTTTATTGGGCATATGCT	729
KRS18AGG	TATGAAATTGGTAAAGTATTTAGAAATGAAGGTATAGATAATACACATAATCCTGAATTTACTTCGAGGGAATTTTATTGGGCATATGCT	532
KRS18GGT	TATGAAATTGGTAAAGTATTTAGAAATGAAGGTATAGATAATACACATAATCCTGAATTTACTTCGGGTGAATTTTATTGGGCATATGCT	473
KRS18GGC	TATGAAATTGGTAAAGTATTTAGAAATGAAGGTATAGATAATACACATAATCCTGAATTTACTTCGGGCGAATTTTATTGGGCATATGCT	348
KRS18GGA	TATGAAATTGGTAAAGTATTTAGAAATGAAGGTATAGATAATACACATAATCCTGAATTTACTTCGGGAGAATTTTATTGGGCATATGCT	373
KRS18GGG	TATGAAATTGGTAAAGTATTTAGAAATGAAGGTATAGATAATACACATAATCCTGAATTTACTTCGGGGGAATTTTATTGGGCATATGCT	559
KRS19TTT	TATGAAATTGGTAAAGTATTTAGAAATGAAGGTATAGATAATACACATAATCCTGAATTTACTTCGTGTTTTTTTTATTGGGCATATGCT	1776
KRS19TTC	TATGAAATTGGTAAAGTATTTAGAAATGAAGGTATAGATAATACACATAATCCTGAATTTACTTCGTGTTTCTTTTATTGGGCATATGCT	902
KRS19TTA	TATGAAATTGGTAAAGTATTTAGAAATGAAGGTATAGATAATACACATAATCCTGAATTTACTTCGTGTTTATTTTATTGGGCATATGCT	2368
KRS19TTG	TATGAAATTGGTAAAGTATTTAGAAATGAAGGTATAGATAATACACATAATCCTGAATTTACTTCGTGTTTGTTTTATTGGGCATATGCT	1178
KRS19CTT	TATGAAATTGGTAAAGTATTTAGAAATGAAGGTATAGATAATACACATAATCCTGAATTTACTTCGTGTCTTTTTTATTGGGCATATGCT	786
KRS19CTC	TATGAAATTGGTAAAGTATTTAGAAATGAAGGTATAGATAATACACATAATCCTGAATTTACTTCGTGTCTCTTTTATTGGGCATATGCT	309
KRS19CTA	TATGAAATTGGTAAAGTATTTAGAAATGAAGGTATAGATAATACACATAATCCTGAATTTACTTCGTGTCTATTTTATTGGGCATATGCT	506
KRS19CTG	TATGAAATTGGTAAAGTATTTAGAAATGAAGGTATAGATAATACACATAATCCTGAATTTACTTCGTGTCTGTTTTATTGGGCATATGCT	653
KRS19ATT	TATGAAATTGGTAAAGTATTTAGAAATGAAGGTATAGATAATACACATAATCCTGAATTTACTTCGTGTATTTTTTATTGGGCATATGCT	2156
KRS19ATC	TATGAAATTGGTAAAGTATTTAGAAATGAAGGTATAGATAATACACATAATCCTGAATTTACTTCGTGTATCTTTTATTGGGCATATGCT	674
KRS19ATA	TATGAAATTGGTAAAGTATTTAGAAATGAAGGTATAGATAATACACATAATCCTGAATTTACTTCGTGTATATTTTATTGGGCATATGCT	88827
KRS19ATG	TATGAAATTGGTAAAGTATTTAGAAATGAAGGTATAGATAATACACATAATCCTGAATTTACTTCGTGTATGTTTTATTGGGCATATGCT	1027
KRS19GTT	TATGAAATTGGTAAAGTATTTAGAAATGAAGGTATAGATAATACACATAATCCTGAATTTACTTCGTGTGTTTTTTATTGGGCATATGCT	564
KRS19GTC	TATGAAATTGGTAAAGTATTTAGAAATGAAGGTATAGATAATACACATAATCCTGAATTTACTTCGTGTGTCTTTTATTGGGCATATGCT	370
KRS19GTA	TATGAAATTGGTAAAGTATTTAGAAATGAAGGTATAGATAATACACATAATCCTGAATTTACTTCGTGTGTATTTTATTGGGCATATGCT	793
KRS19GTG	TATGAAATTGGTAAAGTATTTAGAAATGAAGGTATAGATAATACACATAATCCTGAATTTACTTCGTGTGTGTTTTATTGGGCATATGCT	642
KRS19TCT	TATGAAATTGGTAAAGTATTTAGAAATGAAGGTATAGATAATACACATAATCCTGAATTTACTTCGTGTTCTTTTTATTGGGCATATGCT	961
KRS19TCC	TATGAAATTGGTAAAGTATTTAGAAATGAAGGTATAGATAATACACATAATCCTGAATTTACTTCGTGTTCCTTTTATTGGGCATATGCT	654
KRS19TCA	TATGAAATTGGTAAAGTATTTAGAAATGAAGGTATAGATAATACACATAATCCTGAATTTACTTCGTGTTCATTTTATTGGGCATATGCT	1258
KRS19TCG	TATGAAATTGGTAAAGTATTTAGAAATGAAGGTATAGATAATACACATAATCCTGAATTTACTTCGTGTTCGTTTTATTGGGCATATGCT	699
KRS19CCT	TATGAAATTGGTAAAGTATTTAGAAATGAAGGTATAGATAATACACATAATCCTGAATTTACTTCGTGTCCTTTTTATTGGGCATATGCT	236
KRS19CCC	TATGAAATTGGTAAAGTATTTAGAAATGAAGGTATAGATAATACACATAATCCTGAATTTACTTCGTGTCCCTTTTATTGGGCATATGCT	105
KRS19CCA	TATGAAATTGGTAAAGTATTTAGAAATGAAGGTATAGATAATACACATAATCCTGAATTTACTTCGTGTCCATTTTATTGGGCATATGCT	238
KRS19CCG	TATGAAATTGGTAAAGTATTTAGAAATGAAGGTATAGATAATACACATAATCCTGAATTTACTTCGTGTCCGTTTTATTGGGCATATGCT	438
KRS19ACT	TATGAAATTGGTAAAGTATTTAGAAATGAAGGTATAGATAATACACATAATCCTGAATTTACTTCGTGTACTTTTTATTGGGCATATGCT	695
KRS19ACC	TATGAAATTGGTAAAGTATTTAGAAATGAAGGTATAGATAATACACATAATCCTGAATTTACTTCGTGTACCTTTTATTGGGCATATGCT	292
KRS19ACA	TATGAAATTGGTAAAGTATTTAGAAATGAAGGTATAGATAATACACATAATCCTGAATTTACTTCGTGTACATTTTATTGGGCATATGCT	1977
KRS19ACG	TATGAAATTGGTAAAGTATTTAGAAATGAAGGTATAGATAATACACATAATCCTGAATTTACTTCGTGTACGTTTTATTGGGCATATGCT	324
KRS19GCT	TATGAAATTGGTAAAGTATTTAGAAATGAAGGTATAGATAATACACATAATCCTGAATTTACTTCGTGTGCTTTTTATTGGGCATATGCT	502
KRS19GCC	TATGAAATTGGTAAAGTATTTAGAAATGAAGGTATAGATAATACACATAATCCTGAATTTACTTCGTGTGCCTTTTATTGGGCATATGCT	230
KRS19GCA	TATGAAATTGGTAAAGTATTTAGAAATGAAGGTATAGATAATACACATAATCCTGAATTTACTTCGTGTGCATTTTATTGGGCATATGCT	375
KRS19GCG	TATGAAATTGGTAAAGTATTTAGAAATGAAGGTATAGATAATACACATAATCCTGAATTTACTTCGTGTGCGTTTTATTGGGCATATGCT	458
KRS19TAT	TATGAAATTGGTAAAGTATTTAGAAATGAAGGTATAGATAATACACATAATCCTGAATTTACTTCGTGTTATTTTTATTGGGCATATGCT	1607
KRS19TAC	TATGAAATTGGTAAAGTATTTAGAAATGAAGGTATAGATAATACACATAATCCTGAATTTACTTCGTGTTACTTTTATTGGGCATATGCT	953
KRS19TAA	TATGAAATTGGTAAAGTATTTAGAAATGAAGGTATAGATAATACACATAATCCTGAATTTACTTCGTGTTAATTTTATTGGGCATATGCT	4579
KRS19TAG	TATGAAATTGGTAAAGTATTTAGAAATGAAGGTATAGATAATACACATAATCCTGAATTTACTTCGTGTTAGTTTTATTGGGCATATGCT	1095
KRS19CAT	TATGAAATTGGTAAAGTATTTAGAAATGAAGGTATAGATAATACACATAATCCTGAATTTACTTCGTGTCATTTTTATTGGGCATATGCT	672
KRS19CAC	TATGAAATTGGTAAAGTATTTAGAAATGAAGGTATAGATAATACACATAATCCTGAATTTACTTCGTGTCACTTTTATTGGGCATATGCT	354
KRS19CAA	TATGAAATTGGTAAAGTATTTAGAAATGAAGGTATAGATAATACACATAATCCTGAATTTACTTCGTGTCAATTTTATTGGGCATATGCT	908
KRS19CAG	TATGAAATTGGTAAAGTATTTAGAAATGAAGGTATAGATAATACACATAATCCTGAATTTACTTCGTGTCAGTTTTATTGGGCATATGCT	391
KRS19AAT	TATGAAATTGGTAAAGTATTTAGAAATGAAGGTATAGATAATACACATAATCCTGAATTTACTTCGTGTAATTTTTATTGGGCATATGCT	3289
KRS19AAC	TATGAAATTGGTAAAGTATTTAGAAATGAAGGTATAGATAATACACATAATCCTGAATTTACTTCGTGTAACTTTTATTGGGCATATGCT	1117
KRS19AAA	TATGAAATTGGTAAAGTATTTAGAAATGAAGGTATAGATAATACACATAATCCTGAATTTACTTCGTGTAAATTTTATTGGGCATATGCT	13466
KRS19AAG	TATGAAATTGGTAAAGTATTTAGAAATGAAGGTATAGATAATACACATAATCCTGAATTTACTTCGTGTAAGTTTTATTGGGCATATGCT	1412
KRS19GAT	TATGAAATTGGTAAAGTATTTAGAAATGAAGGTATAGATAATACACATAATCCTGAATTTACTTCGTGTGATTTTTATTGGGCATATGCT	627
KRS19GAC	TATGAAATTGGTAAAGTATTTAGAAATGAAGGTATAGATAATACACATAATCCTGAATTTACTTCGTGTGACTTTTATTGGGCATATGCT	232
KRS19GAA	TATGAAATTGGTAAAGTATTTAGAAATGAAGGTATAGATAATACACATAATCCTGAATTTACTTCGTGTGAATTTTATTGGGCATATGCT	53004
KRS19GAG	TATGAAATTGGTAAAGTATTTAGAAATGAAGGTATAGATAATACACATAATCCTGAATTTACTTCGTGTGAGTTTTATTGGGCATATGCT	295
KRS19TGT	TATGAAATTGGTAAAGTATTTAGAAATGAAGGTATAGATAATACACATAATCCTGAATTTACTTCGTGTTGTTTTTATTGGGCATATGCT	1630
KRS19TGC	TATGAAATTGGTAAAGTATTTAGAAATGAAGGTATAGATAATACACATAATCCTGAATTTACTTCGTGTTGCTTTTATTGGGCATATGCT	1469
KRS19TGA	TATGAAATTGGTAAAGTATTTAGAAATGAAGGTATAGATAATACACATAATCCTGAATTTACTTCGTGTTGATTTTATTGGGCATATGCT	2654
KRS19TGG	TATGAAATTGGTAAAGTATTTAGAAATGAAGGTATAGATAATACACATAATCCTGAATTTACTTCGTGTTGGTTTTATTGGGCATATGCT	880
KRS19CGT	TATGAAATTGGTAAAGTATTTAGAAATGAAGGTATAGATAATACACATAATCCTGAATTTACTTCGTGTCGTTTTTATTGGGCATATGCT	449
KRS19CGC	TATGAAATTGGTAAAGTATTTAGAAATGAAGGTATAGATAATACACATAATCCTGAATTTACTTCGTGTCGCTTTTATTGGGCATATGCT	249
KRS19CGA	TATGAAATTGGTAAAGTATTTAGAAATGAAGGTATAGATAATACACATAATCCTGAATTTACTTCGTGTCGATTTTATTGGGCATATGCT	341
KRS19CGG	TATGAAATTGGTAAAGTATTTAGAAATGAAGGTATAGATAATACACATAATCCTGAATTTACTTCGTGTCGGTTTTATTGGGCATATGCT	242
KRS19AGT	TATGAAATTGGTAAAGTATTTAGAAATGAAGGTATAGATAATACACATAATCCTGAATTTACTTCGTGTAGTTTTTATTGGGCATATGCT	1018
KRS19AGC	TATGAAATTGGTAAAGTATTTAGAAATGAAGGTATAGATAATACACATAATCCTGAATTTACTTCGTGTAGCTTTTATTGGGCATATGCT	672
KRS19AGA	TATGAAATTGGTAAAGTATTTAGAAATGAAGGTATAGATAATACACATAATCCTGAATTTACTTCGTGTAGATTTTATTGGGCATATGCT	1204
KRS19AGG	TATGAAATTGGTAAAGTATTTAGAAATGAAGGTATAGATAATACACATAATCCTGAATTTACTTCGTGTAGGTTTTATTGGGCATATGCT	332
KRS19GGT	TATGAAATTGGTAAAGTATTTAGAAATGAAGGTATAGATAATACACATAATCCTGAATTTACTTCGTGTGGTTTTTATTGGGCATATGCT	776
KRS19GGC	TATGAAATTGGTAAAGTATTTAGAAATGAAGGTATAGATAATACACATAATCCTGAATTTACTTCGTGTGGCTTTTATTGGGCATATGCT	270
KRS19GGA	TATGAAATTGGTAAAGTATTTAGAAATGAAGGTATAGATAATACACATAATCCTGAATTTACTTCGTGTGGATTTTATTGGGCATATGCT	673
KRS19GGG	TATGAAATTGGTAAAGTATTTAGAAATGAAGGTATAGATAATACACATAATCCTGAATTTACTTCGTGTGGGTTTTATTGGGCATATGCT	335
KRS20TTT	TATGAAATTGGTAAAGTATTTAGAAATGAAGGTATAGATAATACACATAATCCTGAATTTACTTCGTGTGAATTTTATTGGGCATATGCT	53004
KRS20TTC	TATGAAATTGGTAAAGTATTTAGAAATGAAGGTATAGATAATACACATAATCCTGAATTTACTTCGTGTGAATTCTATTGGGCATATGCT	1398
KRS20TTA	TATGAAATTGGTAAAGTATTTAGAAATGAAGGTATAGATAATACACATAATCCTGAATTTACTTCGTGTGAATTATATTGGGCATATGCT	3053
KRS20TTG	TATGAAATTGGTAAAGTATTTAGAAATGAAGGTATAGATAATACACATAATCCTGAATTTACTTCGTGTGAATTGTATTGGGCATATGCT	4598
KRS20CTT	TATGAAATTGGTAAAGTATTTAGAAATGAAGGTATAGATAATACACATAATCCTGAATTTACTTCGTGTGAACTTTATTGGGCATATGCT	1162
KRS20CTC	TATGAAATTGGTAAAGTATTTAGAAATGAAGGTATAGATAATACACATAATCCTGAATTTACTTCGTGTGAACTCTATTGGGCATATGCT	731
KRS20CTA	TATGAAATTGGTAAAGTATTTAGAAATGAAGGTATAGATAATACACATAATCCTGAATTTACTTCGTGTGAACTATATTGGGCATATGCT	1283
KRS20CTG	TATGAAATTGGTAAAGTATTTAGAAATGAAGGTATAGATAATACACATAATCCTGAATTTACTTCGTGTGAACTGTATTGGGCATATGCT	1927
KRS20ATT	TATGAAATTGGTAAAGTATTTAGAAATGAAGGTATAGATAATACACATAATCCTGAATTTACTTCGTGTGAAATTTATTGGGCATATGCT	20878
KRS20ATC	TATGAAATTGGTAAAGTATTTAGAAATGAAGGTATAGATAATACACATAATCCTGAATTTACTTCGTGTGAAATCTATTGGGCATATGCT	1204
KRS20ATA	TATGAAATTGGTAAAGTATTTAGAAATGAAGGTATAGATAATACACATAATCCTGAATTTACTTCGTGTGAAATATATTGGGCATATGCT	2577
KRS20ATG	TATGAAATTGGTAAAGTATTTAGAAATGAAGGTATAGATAATACACATAATCCTGAATTTACTTCGTGTGAAATGTATTGGGCATATGCT	1670
KRS20GTT	TATGAAATTGGTAAAGTATTTAGAAATGAAGGTATAGATAATACACATAATCCTGAATTTACTTCGTGTGAAGTTTATTGGGCATATGCT	638
KRS20GTC	TATGAAATTGGTAAAGTATTTAGAAATGAAGGTATAGATAATACACATAATCCTGAATTTACTTCGTGTGAAGTCTATTGGGCATATGCT	349
KRS20GTA	TATGAAATTGGTAAAGTATTTAGAAATGAAGGTATAGATAATACACATAATCCTGAATTTACTTCGTGTGAAGTATATTGGGCATATGCT	815
KRS20GTG	TATGAAATTGGTAAAGTATTTAGAAATGAAGGTATAGATAATACACATAATCCTGAATTTACTTCGTGTGAAGTGTATTGGGCATATGCT	878
KRS20TCT	TATGAAATTGGTAAAGTATTTAGAAATGAAGGTATAGATAATACACATAATCCTGAATTTACTTCGTGTGAATCTTATTGGGCATATGCT	1058
KRS20TCC	TATGAAATTGGTAAAGTATTTAGAAATGAAGGTATAGATAATACACATAATCCTGAATTTACTTCGTGTGAATCCTATTGGGCATATGCT	1836
KRS20TCA	TATGAAATTGGTAAAGTATTTAGAAATGAAGGTATAGATAATACACATAATCCTGAATTTACTTCGTGTGAATCATATTGGGCATATGCT	2165
KRS20TCG	TATGAAATTGGTAAAGTATTTAGAAATGAAGGTATAGATAATACACATAATCCTGAATTTACTTCGTGTGAATCGTATTGGGCATATGCT	1161
KRS20CCT	TATGAAATTGGTAAAGTATTTAGAAATGAAGGTATAGATAATACACATAATCCTGAATTTACTTCGTGTGAACCTTATTGGGCATATGCT	1927
KRS20CCC	TATGAAATTGGTAAAGTATTTAGAAATGAAGGTATAGATAATACACATAATCCTGAATTTACTTCGTGTGAACCCTATTGGGCATATGCT	661
KRS20CCA	TATGAAATTGGTAAAGTATTTAGAAATGAAGGTATAGATAATACACATAATCCTGAATTTACTTCGTGTGAACCATATTGGGCATATGCT	953
KRS20CCG	TATGAAATTGGTAAAGTATTTAGAAATGAAGGTATAGATAATACACATAATCCTGAATTTACTTCGTGTGAACCGTATTGGGCATATGCT	826
KRS20ACT	TATGAAATTGGTAAAGTATTTAGAAATGAAGGTATAGATAATACACATAATCCTGAATTTACTTCGTGTGAAACTTATTGGGCATATGCT	1025
KRS20ACC	TATGAAATTGGTAAAGTATTTAGAAATGAAGGTATAGATAATACACATAATCCTGAATTTACTTCGTGTGAAACCTATTGGGCATATGCT	512
KRS20ACA	TATGAAATTGGTAAAGTATTTAGAAATGAAGGTATAGATAATACACATAATCCTGAATTTACTTCGTGTGAAACATATTGGGCATATGCT	80788
KRS20ACG	TATGAAATTGGTAAAGTATTTAGAAATGAAGGTATAGATAATACACATAATCCTGAATTTACTTCGTGTGAAACGTATTGGGCATATGCT	1145
KRS20GCT	TATGAAATTGGTAAAGTATTTAGAAATGAAGGTATAGATAATACACATAATCCTGAATTTACTTCGTGTGAAGCTTATTGGGCATATGCT	426
KRS20GCC	TATGAAATTGGTAAAGTATTTAGAAATGAAGGTATAGATAATACACATAATCCTGAATTTACTTCGTGTGAAGCCTATTGGGCATATGCT	274
KRS20GCA	TATGAAATTGGTAAAGTATTTAGAAATGAAGGTATAGATAATACACATAATCCTGAATTTACTTCGTGTGAAGCATATTGGGCATATGCT	1825
KRS20GCG	TATGAAATTGGTAAAGTATTTAGAAATGAAGGTATAGATAATACACATAATCCTGAATTTACTTCGTGTGAAGCGTATTGGGCATATGCT	539
KRS20TAT	TATGAAATTGGTAAAGTATTTAGAAATGAAGGTATAGATAATACACATAATCCTGAATTTACTTCGTGTGAATATTATTGGGCATATGCT	1793
KRS20TAC	TATGAAATTGGTAAAGTATTTAGAAATGAAGGTATAGATAATACACATAATCCTGAATTTACTTCGTGTGAATACTATTGGGCATATGCT	1931
KRS20TAA	TATGAAATTGGTAAAGTATTTAGAAATGAAGGTATAGATAATACACATAATCCTGAATTTACTTCGTGTGAATAATATTGGGCATATGCT	84787
KRS20TAG	TATGAAATTGGTAAAGTATTTAGAAATGAAGGTATAGATAATACACATAATCCTGAATTTACTTCGTGTGAATAGTATTGGGCATATGCT	2122
KRS20CAT	TATGAAATTGGTAAAGTATTTAGAAATGAAGGTATAGATAATACACATAATCCTGAATTTACTTCGTGTGAACATTATTGGGCATATGCT	2198
KRS20CAC	TATGAAATTGGTAAAGTATTTAGAAATGAAGGTATAGATAATACACATAATCCTGAATTTACTTCGTGTGAACACTATTGGGCATATGCT	1246
KRS20CAA	TATGAAATTGGTAAAGTATTTAGAAATGAAGGTATAGATAATACACATAATCCTGAATTTACTTCGTGTGAACAATATTGGGCATATGCT	4577
KRS20CAG	TATGAAATTGGTAAAGTATTTAGAAATGAAGGTATAGATAATACACATAATCCTGAATTTACTTCGTGTGAACAGTATTGGGCATATGCT	1561
KRS20AAT	TATGAAATTGGTAAAGTATTTAGAAATGAAGGTATAGATAATACACATAATCCTGAATTTACTTCGTGTGAAAATTATTGGGCATATGCT	5036
KRS20AAC	TATGAAATTGGTAAAGTATTTAGAAATGAAGGTATAGATAATACACATAATCCTGAATTTACTTCGTGTGAAAACTATTGGGCATATGCT	3309
KRS20AAA	TATGAAATTGGTAAAGTATTTAGAAATGAAGGTATAGATAATACACATAATCCTGAATTTACTTCGTGTGAAAAATATTGGGCATATGCT	17355
KRS20AAG	TATGAAATTGGTAAAGTATTTAGAAATGAAGGTATAGATAATACACATAATCCTGAATTTACTTCGTGTGAAAAGTATTGGGCATATGCT	3395
KRS20GAT	TATGAAATTGGTAAAGTATTTAGAAATGAAGGTATAGATAATACACATAATCCTGAATTTACTTCGTGTGAAGATTATTGGGCATATGCT	903
KRS20GAC	TATGAAATTGGTAAAGTATTTAGAAATGAAGGTATAGATAATACACATAATCCTGAATTTACTTCGTGTGAAGACTATTGGGCATATGCT	564
KRS20GAA	TATGAAATTGGTAAAGTATTTAGAAATGAAGGTATAGATAATACACATAATCCTGAATTTACTTCGTGTGAAGAATATTGGGCATATGCT	2187
KRS20GAG	TATGAAATTGGTAAAGTATTTAGAAATGAAGGTATAGATAATACACATAATCCTGAATTTACTTCGTGTGAAGAGTATTGGGCATATGCT	1017
KRS20TGT	TATGAAATTGGTAAAGTATTTAGAAATGAAGGTATAGATAATACACATAATCCTGAATTTACTTCGTGTGAATGTTATTGGGCATATGCT	1499
KRS20TGC	TATGAAATTGGTAAAGTATTTAGAAATGAAGGTATAGATAATACACATAATCCTGAATTTACTTCGTGTGAATGCTATTGGGCATATGCT	1729
KRS20TGA	TATGAAATTGGTAAAGTATTTAGAAATGAAGGTATAGATAATACACATAATCCTGAATTTACTTCGTGTGAATGATATTGGGCATATGCT	1952
KRS20TGG	TATGAAATTGGTAAAGTATTTAGAAATGAAGGTATAGATAATACACATAATCCTGAATTTACTTCGTGTGAATGGTATTGGGCATATGCT	2351
KRS20CGT	TATGAAATTGGTAAAGTATTTAGAAATGAAGGTATAGATAATACACATAATCCTGAATTTACTTCGTGTGAACGTTATTGGGCATATGCT	907
KRS20CGC	TATGAAATTGGTAAAGTATTTAGAAATGAAGGTATAGATAATACACATAATCCTGAATTTACTTCGTGTGAACGCTATTGGGCATATGCT	813
KRS20CGA	TATGAAATTGGTAAAGTATTTAGAAATGAAGGTATAGATAATACACATAATCCTGAATTTACTTCGTGTGAACGATATTGGGCATATGCT	673
KRS20CGG	TATGAAATTGGTAAAGTATTTAGAAATGAAGGTATAGATAATACACATAATCCTGAATTTACTTCGTGTGAACGGTATTGGGCATATGCT	1449
KRS20AGT	TATGAAATTGGTAAAGTATTTAGAAATGAAGGTATAGATAATACACATAATCCTGAATTTACTTCGTGTGAAAGTTATTGGGCATATGCT	1052
KRS20AGC	TATGAAATTGGTAAAGTATTTAGAAATGAAGGTATAGATAATACACATAATCCTGAATTTACTTCGTGTGAAAGCTATTGGGCATATGCT	1057
KRS20AGA	TATGAAATTGGTAAAGTATTTAGAAATGAAGGTATAGATAATACACATAATCCTGAATTTACTTCGTGTGAAAGATATTGGGCATATGCT	3503
KRS20AGG	TATGAAATTGGTAAAGTATTTAGAAATGAAGGTATAGATAATACACATAATCCTGAATTTACTTCGTGTGAAAGGTATTGGGCATATGCT	1254
KRS20GGT	TATGAAATTGGTAAAGTATTTAGAAATGAAGGTATAGATAATACACATAATCCTGAATTTACTTCGTGTGAAGGTTATTGGGCATATGCT	718
KRS20GGC	TATGAAATTGGTAAAGTATTTAGAAATGAAGGTATAGATAATACACATAATCCTGAATTTACTTCGTGTGAAGGCTATTGGGCATATGCT	1405
KRS20GGA	TATGAAATTGGTAAAGTATTTAGAAATGAAGGTATAGATAATACACATAATCCTGAATTTACTTCGTGTGAAGGATATTGGGCATATGCT	769
KRS20GGG	TATGAAATTGGTAAAGTATTTAGAAATGAAGGTATAGATAATACACATAATCCTGAATTTACTTCGTGTGAAGGGTATTGGGCATATGCT	655
KRS_1TTT	TATGAAATTGGTTTTGTATTTAGAAATGAAGGTATAGATAATACACATAATCCTGAATTTACTTCGTGTGAATTTTATTGGGCATATGCT	0
KRS_1TTC	TATGAAATTGGTTTCGTATTTAGAAATGAAGGTATAGATAATACACATAATCCTGAATTTACTTCGTGTGAATTTTATTGGGCATATGCT	0
KRS_1TTA	TATGAAATTGGTTTAGTATTTAGAAATGAAGGTATAGATAATACACATAATCCTGAATTTACTTCGTGTGAATTTTATTGGGCATATGCT	0
KRS_1TTG	TATGAAATTGGTTTGGTATTTAGAAATGAAGGTATAGATAATACACATAATCCTGAATTTACTTCGTGTGAATTTTATTGGGCATATGCT	0
KRS_1CTT	TATGAAATTGGTCTTGTATTTAGAAATGAAGGTATAGATAATACACATAATCCTGAATTTACTTCGTGTGAATTTTATTGGGCATATGCT	0
KRS_1CTC	TATGAAATTGGTCTCGTATTTAGAAATGAAGGTATAGATAATACACATAATCCTGAATTTACTTCGTGTGAATTTTATTGGGCATATGCT	0
KRS_1CTA	TATGAAATTGGTCTAGTATTTAGAAATGAAGGTATAGATAATACACATAATCCTGAATTTACTTCGTGTGAATTTTATTGGGCATATGCT	0
KRS_1CTG	TATGAAATTGGTCTGGTATTTAGAAATGAAGGTATAGATAATACACATAATCCTGAATTTACTTCGTGTGAATTTTATTGGGCATATGCT	0
KRS_1ATT	TATGAAATTGGTATTGTATTTAGAAATGAAGGTATAGATAATACACATAATCCTGAATTTACTTCGTGTGAATTTTATTGGGCATATGCT	0
KRS_1ATC	TATGAAATTGGTATCGTATTTAGAAATGAAGGTATAGATAATACACATAATCCTGAATTTACTTCGTGTGAATTTTATTGGGCATATGCT	0
KRS_1ATA	TATGAAATTGGTATAGTATTTAGAAATGAAGGTATAGATAATACACATAATCCTGAATTTACTTCGTGTGAATTTTATTGGGCATATGCT	36
KRS_1ATG	TATGAAATTGGTATGGTATTTAGAAATGAAGGTATAGATAATACACATAATCCTGAATTTACTTCGTGTGAATTTTATTGGGCATATGCT	0
KRS_1GTT	TATGAAATTGGTGTTGTATTTAGAAATGAAGGTATAGATAATACACATAATCCTGAATTTACTTCGTGTGAATTTTATTGGGCATATGCT	0
KRS_1GTC	TATGAAATTGGTGTCGTATTTAGAAATGAAGGTATAGATAATACACATAATCCTGAATTTACTTCGTGTGAATTTTATTGGGCATATGCT	0
KRS_1GTA	TATGAAATTGGTGTAGTATTTAGAAATGAAGGTATAGATAATACACATAATCCTGAATTTACTTCGTGTGAATTTTATTGGGCATATGCT	0
KRS_1GTG	TATGAAATTGGTGTGGTATTTAGAAATGAAGGTATAGATAATACACATAATCCTGAATTTACTTCGTGTGAATTTTATTGGGCATATGCT	0
KRS_1TCT	TATGAAATTGGTTCTGTATTTAGAAATGAAGGTATAGATAATACACATAATCCTGAATTTACTTCGTGTGAATTTTATTGGGCATATGCT	0
KRS_1TCC	TATGAAATTGGTTCCGTATTTAGAAATGAAGGTATAGATAATACACATAATCCTGAATTTACTTCGTGTGAATTTTATTGGGCATATGCT	0
KRS_1TCA	TATGAAATTGGTTCAGTATTTAGAAATGAAGGTATAGATAATACACATAATCCTGAATTTACTTCGTGTGAATTTTATTGGGCATATGCT	0
KRS_1TCG	TATGAAATTGGTTCGGTATTTAGAAATGAAGGTATAGATAATACACATAATCCTGAATTTACTTCGTGTGAATTTTATTGGGCATATGCT	0
KRS_1CCT	TATGAAATTGGTCCTGTATTTAGAAATGAAGGTATAGATAATACACATAATCCTGAATTTACTTCGTGTGAATTTTATTGGGCATATGCT	0
KRS_1CCC	TATGAAATTGGTCCCGTATTTAGAAATGAAGGTATAGATAATACACATAATCCTGAATTTACTTCGTGTGAATTTTATTGGGCATATGCT	0
KRS_1CCA	TATGAAATTGGTCCAGTATTTAGAAATGAAGGTATAGATAATACACATAATCCTGAATTTACTTCGTGTGAATTTTATTGGGCATATGCT	0
KRS_1CCG	TATGAAATTGGTCCGGTATTTAGAAATGAAGGTATAGATAATACACATAATCCTGAATTTACTTCGTGTGAATTTTATTGGGCATATGCT	0
KRS_1ACT	TATGAAATTGGTACTGTATTTAGAAATGAAGGTATAGATAATACACATAATCCTGAATTTACTTCGTGTGAATTTTATTGGGCATATGCT	0
KRS_1ACC	TATGAAATTGGTACCGTATTTAGAAATGAAGGTATAGATAATACACATAATCCTGAATTTACTTCGTGTGAATTTTATTGGGCATATGCT	0
KRS_1ACA	TATGAAATTGGTACAGTATTTAGAAATGAAGGTATAGATAATACACATAATCCTGAATTTACTTCGTGTGAATTTTATTGGGCATATGCT	17
KRS_1ACG	TATGAAATTGGTACGGTATTTAGAAATGAAGGTATAGATAATACACATAATCCTGAATTTACTTCGTGTGAATTTTATTGGGCATATGCT	0
KRS_1GCT	TATGAAATTGGTGCTGTATTTAGAAATGAAGGTATAGATAATACACATAATCCTGAATTTACTTCGTGTGAATTTTATTGGGCATATGCT	0
KRS_1GCC	TATGAAATTGGTGCCGTATTTAGAAATGAAGGTATAGATAATACACATAATCCTGAATTTACTTCGTGTGAATTTTATTGGGCATATGCT	0
KRS_1GCA	TATGAAATTGGTGCAGTATTTAGAAATGAAGGTATAGATAATACACATAATCCTGAATTTACTTCGTGTGAATTTTATTGGGCATATGCT	0
KRS_1GCG	TATGAAATTGGTGCGGTATTTAGAAATGAAGGTATAGATAATACACATAATCCTGAATTTACTTCGTGTGAATTTTATTGGGCATATGCT	0
KRS_1TAT	TATGAAATTGGTTATGTATTTAGAAATGAAGGTATAGATAATACACATAATCCTGAATTTACTTCGTGTGAATTTTATTGGGCATATGCT	0
KRS_1TAC	TATGAAATTGGTTACGTATTTAGAAATGAAGGTATAGATAATACACATAATCCTGAATTTACTTCGTGTGAATTTTATTGGGCATATGCT	0
KRS_1TAA	TATGAAATTGGTTAAGTATTTAGAAATGAAGGTATAGATAATACACATAATCCTGAATTTACTTCGTGTGAATTTTATTGGGCATATGCT	73
KRS_1TAG	TATGAAATTGGTTAGGTATTTAGAAATGAAGGTATAGATAATACACATAATCCTGAATTTACTTCGTGTGAATTTTATTGGGCATATGCT	0
KRS_1CAT	TATGAAATTGGTCATGTATTTAGAAATGAAGGTATAGATAATACACATAATCCTGAATTTACTTCGTGTGAATTTTATTGGGCATATGCT	0
KRS_1CAC	TATGAAATTGGTCACGTATTTAGAAATGAAGGTATAGATAATACACATAATCCTGAATTTACTTCGTGTGAATTTTATTGGGCATATGCT	0
KRS_1CAA	TATGAAATTGGTCAAGTATTTAGAAATGAAGGTATAGATAATACACATAATCCTGAATTTACTTCGTGTGAATTTTATTGGGCATATGCT	11
KRS_1CAG	TATGAAATTGGTCAGGTATTTAGAAATGAAGGTATAGATAATACACATAATCCTGAATTTACTTCGTGTGAATTTTATTGGGCATATGCT	0
KRS_1AAT	TATGAAATTGGTAATGTATTTAGAAATGAAGGTATAGATAATACACATAATCCTGAATTTACTTCGTGTGAATTTTATTGGGCATATGCT	26
KRS_1AAC	TATGAAATTGGTAACGTATTTAGAAATGAAGGTATAGATAATACACATAATCCTGAATTTACTTCGTGTGAATTTTATTGGGCATATGCT	5
KRS_1AAA	TATGAAATTGGTAAAGTATTTAGAAATGAAGGTATAGATAATACACATAATCCTGAATTTACTTCGTGTGAATTTTATTGGGCATATGCT	53004
KRS_1AAG	TATGAAATTGGTAAGGTATTTAGAAATGAAGGTATAGATAATACACATAATCCTGAATTTACTTCGTGTGAATTTTATTGGGCATATGCT	113
KRS_1GAT	TATGAAATTGGTGATGTATTTAGAAATGAAGGTATAGATAATACACATAATCCTGAATTTACTTCGTGTGAATTTTATTGGGCATATGCT	0
KRS_1GAC	TATGAAATTGGTGACGTATTTAGAAATGAAGGTATAGATAATACACATAATCCTGAATTTACTTCGTGTGAATTTTATTGGGCATATGCT	0
KRS_1GAA	TATGAAATTGGTGAAGTATTTAGAAATGAAGGTATAGATAATACACATAATCCTGAATTTACTTCGTGTGAATTTTATTGGGCATATGCT	91
KRS_1GAG	TATGAAATTGGTGAGGTATTTAGAAATGAAGGTATAGATAATACACATAATCCTGAATTTACTTCGTGTGAATTTTATTGGGCATATGCT	0
KRS_1TGT	TATGAAATTGGTTGTGTATTTAGAAATGAAGGTATAGATAATACACATAATCCTGAATTTACTTCGTGTGAATTTTATTGGGCATATGCT	0
KRS_1TGC	TATGAAATTGGTTGCGTATTTAGAAATGAAGGTATAGATAATACACATAATCCTGAATTTACTTCGTGTGAATTTTATTGGGCATATGCT	0
KRS_1TGA	TATGAAATTGGTTGAGTATTTAGAAATGAAGGTATAGATAATACACATAATCCTGAATTTACTTCGTGTGAATTTTATTGGGCATATGCT	0
KRS_1TGG	TATGAAATTGGTTGGGTATTTAGAAATGAAGGTATAGATAATACACATAATCCTGAATTTACTTCGTGTGAATTTTATTGGGCATATGCT	0
KRS_1CGT	TATGAAATTGGTCGTGTATTTAGAAATGAAGGTATAGATAATACACATAATCCTGAATTTACTTCGTGTGAATTTTATTGGGCATATGCT	0
KRS_1CGC	TATGAAATTGGTCGCGTATTTAGAAATGAAGGTATAGATAATACACATAATCCTGAATTTACTTCGTGTGAATTTTATTGGGCATATGCT	0
KRS_1CGA	TATGAAATTGGTCGAGTATTTAGAAATGAAGGTATAGATAATACACATAATCCTGAATTTACTTCGTGTGAATTTTATTGGGCATATGCT	0
KRS_1CGG	TATGAAATTGGTCGGGTATTTAGAAATGAAGGTATAGATAATACACATAATCCTGAATTTACTTCGTGTGAATTTTATTGGGCATATGCT	0
KRS_1AGT	TATGAAATTGGTAGTGTATTTAGAAATGAAGGTATAGATAATACACATAATCCTGAATTTACTTCGTGTGAATTTTATTGGGCATATGCT	0
KRS_1AGC	TATGAAATTGGTAGCGTATTTAGAAATGAAGGTATAGATAATACACATAATCCTGAATTTACTTCGTGTGAATTTTATTGGGCATATGCT	0
KRS_1AGA	TATGAAATTGGTAGAGTATTTAGAAATGAAGGTATAGATAATACACATAATCCTGAATTTACTTCGTGTGAATTTTATTGGGCATATGCT	76
KRS_1AGG	TATGAAATTGGTAGGGTATTTAGAAATGAAGGTATAGATAATACACATAATCCTGAATTTACTTCGTGTGAATTTTATTGGGCATATGCT	0
KRS_1GGT	TATGAAATTGGTGGTGTATTTAGAAATGAAGGTATAGATAATACACATAATCCTGAATTTACTTCGTGTGAATTTTATTGGGCATATGCT	0
KRS_1GGC	TATGAAATTGGTGGCGTATTTAGAAATGAAGGTATAGATAATACACATAATCCTGAATTTACTTCGTGTGAATTTTATTGGGCATATGCT	0
KRS_1GGA	TATGAAATTGGTGGAGTATTTAGAAATGAAGGTATAGATAATACACATAATCCTGAATTTACTTCGTGTGAATTTTATTGGGCATATGCT	0
KRS_1GGG	TATGAAATTGGTGGGGTATTTAGAAATGAAGGTATAGATAATACACATAATCCTGAATTTACTTCGTGTGAATTTTATTGGGCATATGCT	0
KRS21TTT	TATGAAATTGGTAAAGTATTTAGAAATGAAGGTATAGATAATACACATAATCCTGAATTTACTTCGTGTGAATTTTTTTGGGCATATGCT	36
KRS21TTC	TATGAAATTGGTAAAGTATTTAGAAATGAAGGTATAGATAATACACATAATCCTGAATTTACTTCGTGTGAATTTTTCTGGGCATATGCT	0
KRS21TTA	TATGAAATTGGTAAAGTATTTAGAAATGAAGGTATAGATAATACACATAATCCTGAATTTACTTCGTGTGAATTTTTATGGGCATATGCT	0
KRS21TTG	TATGAAATTGGTAAAGTATTTAGAAATGAAGGTATAGATAATACACATAATCCTGAATTTACTTCGTGTGAATTTTTGTGGGCATATGCT	0
KRS21CTT	TATGAAATTGGTAAAGTATTTAGAAATGAAGGTATAGATAATACACATAATCCTGAATTTACTTCGTGTGAATTTCTTTGGGCATATGCT	0
KRS21CTC	TATGAAATTGGTAAAGTATTTAGAAATGAAGGTATAGATAATACACATAATCCTGAATTTACTTCGTGTGAATTTCTCTGGGCATATGCT	0
KRS21CTA	TATGAAATTGGTAAAGTATTTAGAAATGAAGGTATAGATAATACACATAATCCTGAATTTACTTCGTGTGAATTTCTATGGGCATATGCT	0
KRS21CTG	TATGAAATTGGTAAAGTATTTAGAAATGAAGGTATAGATAATACACATAATCCTGAATTTACTTCGTGTGAATTTCTGTGGGCATATGCT	0
KRS21ATT	TATGAAATTGGTAAAGTATTTAGAAATGAAGGTATAGATAATACACATAATCCTGAATTTACTTCGTGTGAATTTATTTGGGCATATGCT	1
KRS21ATC	TATGAAATTGGTAAAGTATTTAGAAATGAAGGTATAGATAATACACATAATCCTGAATTTACTTCGTGTGAATTTATCTGGGCATATGCT	0
KRS21ATA	TATGAAATTGGTAAAGTATTTAGAAATGAAGGTATAGATAATACACATAATCCTGAATTTACTTCGTGTGAATTTATATGGGCATATGCT	0
KRS21ATG	TATGAAATTGGTAAAGTATTTAGAAATGAAGGTATAGATAATACACATAATCCTGAATTTACTTCGTGTGAATTTATGTGGGCATATGCT	0
KRS21GTT	TATGAAATTGGTAAAGTATTTAGAAATGAAGGTATAGATAATACACATAATCCTGAATTTACTTCGTGTGAATTTGTTTGGGCATATGCT	0
KRS21GTC	TATGAAATTGGTAAAGTATTTAGAAATGAAGGTATAGATAATACACATAATCCTGAATTTACTTCGTGTGAATTTGTCTGGGCATATGCT	0
KRS21GTA	TATGAAATTGGTAAAGTATTTAGAAATGAAGGTATAGATAATACACATAATCCTGAATTTACTTCGTGTGAATTTGTATGGGCATATGCT	0
KRS21GTG	TATGAAATTGGTAAAGTATTTAGAAATGAAGGTATAGATAATACACATAATCCTGAATTTACTTCGTGTGAATTTGTGTGGGCATATGCT	0
KRS21TCT	TATGAAATTGGTAAAGTATTTAGAAATGAAGGTATAGATAATACACATAATCCTGAATTTACTTCGTGTGAATTTTCTTGGGCATATGCT	15
KRS21TCC	TATGAAATTGGTAAAGTATTTAGAAATGAAGGTATAGATAATACACATAATCCTGAATTTACTTCGTGTGAATTTTCCTGGGCATATGCT	0
KRS21TCA	TATGAAATTGGTAAAGTATTTAGAAATGAAGGTATAGATAATACACATAATCCTGAATTTACTTCGTGTGAATTTTCATGGGCATATGCT	0
KRS21TCG	TATGAAATTGGTAAAGTATTTAGAAATGAAGGTATAGATAATACACATAATCCTGAATTTACTTCGTGTGAATTTTCGTGGGCATATGCT	0
KRS21CCT	TATGAAATTGGTAAAGTATTTAGAAATGAAGGTATAGATAATACACATAATCCTGAATTTACTTCGTGTGAATTTCCTTGGGCATATGCT	0
KRS21CCC	TATGAAATTGGTAAAGTATTTAGAAATGAAGGTATAGATAATACACATAATCCTGAATTTACTTCGTGTGAATTTCCCTGGGCATATGCT	0
KRS21CCA	TATGAAATTGGTAAAGTATTTAGAAATGAAGGTATAGATAATACACATAATCCTGAATTTACTTCGTGTGAATTTCCATGGGCATATGCT	0
KRS21CCG	TATGAAATTGGTAAAGTATTTAGAAATGAAGGTATAGATAATACACATAATCCTGAATTTACTTCGTGTGAATTTCCGTGGGCATATGCT	0
KRS21ACT	TATGAAATTGGTAAAGTATTTAGAAATGAAGGTATAGATAATACACATAATCCTGAATTTACTTCGTGTGAATTTACTTGGGCATATGCT	0
KRS21ACC	TATGAAATTGGTAAAGTATTTAGAAATGAAGGTATAGATAATACACATAATCCTGAATTTACTTCGTGTGAATTTACCTGGGCATATGCT	0
KRS21ACA	TATGAAATTGGTAAAGTATTTAGAAATGAAGGTATAGATAATACACATAATCCTGAATTTACTTCGTGTGAATTTACATGGGCATATGCT	0
KRS21ACG	TATGAAATTGGTAAAGTATTTAGAAATGAAGGTATAGATAATACACATAATCCTGAATTTACTTCGTGTGAATTTACGTGGGCATATGCT	0
KRS21GCT	TATGAAATTGGTAAAGTATTTAGAAATGAAGGTATAGATAATACACATAATCCTGAATTTACTTCGTGTGAATTTGCTTGGGCATATGCT	0
KRS21GCC	TATGAAATTGGTAAAGTATTTAGAAATGAAGGTATAGATAATACACATAATCCTGAATTTACTTCGTGTGAATTTGCCTGGGCATATGCT	0
KRS21GCA	TATGAAATTGGTAAAGTATTTAGAAATGAAGGTATAGATAATACACATAATCCTGAATTTACTTCGTGTGAATTTGCATGGGCATATGCT	0
KRS21GCG	TATGAAATTGGTAAAGTATTTAGAAATGAAGGTATAGATAATACACATAATCCTGAATTTACTTCGTGTGAATTTGCGTGGGCATATGCT	0
KRS21TAT	TATGAAATTGGTAAAGTATTTAGAAATGAAGGTATAGATAATACACATAATCCTGAATTTACTTCGTGTGAATTTTATTGGGCATATGCT	53004
KRS21TAC	TATGAAATTGGTAAAGTATTTAGAAATGAAGGTATAGATAATACACATAATCCTGAATTTACTTCGTGTGAATTTTACTGGGCATATGCT	39
KRS21TAA	TATGAAATTGGTAAAGTATTTAGAAATGAAGGTATAGATAATACACATAATCCTGAATTTACTTCGTGTGAATTTTAATGGGCATATGCT	7
KRS21TAG	TATGAAATTGGTAAAGTATTTAGAAATGAAGGTATAGATAATACACATAATCCTGAATTTACTTCGTGTGAATTTTAGTGGGCATATGCT	14
KRS21CAT	TATGAAATTGGTAAAGTATTTAGAAATGAAGGTATAGATAATACACATAATCCTGAATTTACTTCGTGTGAATTTCATTGGGCATATGCT	10
KRS21CAC	TATGAAATTGGTAAAGTATTTAGAAATGAAGGTATAGATAATACACATAATCCTGAATTTACTTCGTGTGAATTTCACTGGGCATATGCT	0
KRS21CAA	TATGAAATTGGTAAAGTATTTAGAAATGAAGGTATAGATAATACACATAATCCTGAATTTACTTCGTGTGAATTTCAATGGGCATATGCT	0
KRS21CAG	TATGAAATTGGTAAAGTATTTAGAAATGAAGGTATAGATAATACACATAATCCTGAATTTACTTCGTGTGAATTTCAGTGGGCATATGCT	0
KRS21AAT	TATGAAATTGGTAAAGTATTTAGAAATGAAGGTATAGATAATACACATAATCCTGAATTTACTTCGTGTGAATTTAATTGGGCATATGCT	9
KRS21AAC	TATGAAATTGGTAAAGTATTTAGAAATGAAGGTATAGATAATACACATAATCCTGAATTTACTTCGTGTGAATTTAACTGGGCATATGCT	0
KRS21AAA	TATGAAATTGGTAAAGTATTTAGAAATGAAGGTATAGATAATACACATAATCCTGAATTTACTTCGTGTGAATTTAAATGGGCATATGCT	0
KRS21AAG	TATGAAATTGGTAAAGTATTTAGAAATGAAGGTATAGATAATACACATAATCCTGAATTTACTTCGTGTGAATTTAAGTGGGCATATGCT	0
KRS21GAT	TATGAAATTGGTAAAGTATTTAGAAATGAAGGTATAGATAATACACATAATCCTGAATTTACTTCGTGTGAATTTGATTGGGCATATGCT	5
KRS21GAC	TATGAAATTGGTAAAGTATTTAGAAATGAAGGTATAGATAATACACATAATCCTGAATTTACTTCGTGTGAATTTGACTGGGCATATGCT	0
KRS21GAA	TATGAAATTGGTAAAGTATTTAGAAATGAAGGTATAGATAATACACATAATCCTGAATTTACTTCGTGTGAATTTGAATGGGCATATGCT	0
KRS21GAG	TATGAAATTGGTAAAGTATTTAGAAATGAAGGTATAGATAATACACATAATCCTGAATTTACTTCGTGTGAATTTGAGTGGGCATATGCT	0
KRS21TGT	TATGAAATTGGTAAAGTATTTAGAAATGAAGGTATAGATAATACACATAATCCTGAATTTACTTCGTGTGAATTTTGTTGGGCATATGCT	51
KRS21TGC	TATGAAATTGGTAAAGTATTTAGAAATGAAGGTATAGATAATACACATAATCCTGAATTTACTTCGTGTGAATTTTGCTGGGCATATGCT	0
KRS21TGA	TATGAAATTGGTAAAGTATTTAGAAATGAAGGTATAGATAATACACATAATCCTGAATTTACTTCGTGTGAATTTTGATGGGCATATGCT	0
KRS21TGG	TATGAAATTGGTAAAGTATTTAGAAATGAAGGTATAGATAATACACATAATCCTGAATTTACTTCGTGTGAATTTTGGTGGGCATATGCT	0
KRS21CGT	TATGAAATTGGTAAAGTATTTAGAAATGAAGGTATAGATAATACACATAATCCTGAATTTACTTCGTGTGAATTTCGTTGGGCATATGCT	0
KRS21CGC	TATGAAATTGGTAAAGTATTTAGAAATGAAGGTATAGATAATACACATAATCCTGAATTTACTTCGTGTGAATTTCGCTGGGCATATGCT	0
KRS21CGA	TATGAAATTGGTAAAGTATTTAGAAATGAAGGTATAGATAATACACATAATCCTGAATTTACTTCGTGTGAATTTCGATGGGCATATGCT	0
KRS21CGG	TATGAAATTGGTAAAGTATTTAGAAATGAAGGTATAGATAATACACATAATCCTGAATTTACTTCGTGTGAATTTCGGTGGGCATATGCT	0
KRS21AGT	TATGAAATTGGTAAAGTATTTAGAAATGAAGGTATAGATAATACACATAATCCTGAATTTACTTCGTGTGAATTTAGTTGGGCATATGCT	0
KRS21AGC	TATGAAATTGGTAAAGTATTTAGAAATGAAGGTATAGATAATACACATAATCCTGAATTTACTTCGTGTGAATTTAGCTGGGCATATGCT	0
KRS21AGA	TATGAAATTGGTAAAGTATTTAGAAATGAAGGTATAGATAATACACATAATCCTGAATTTACTTCGTGTGAATTTAGATGGGCATATGCT	0
KRS21AGG	TATGAAATTGGTAAAGTATTTAGAAATGAAGGTATAGATAATACACATAATCCTGAATTTACTTCGTGTGAATTTAGGTGGGCATATGCT	0
KRS21GGT	TATGAAATTGGTAAAGTATTTAGAAATGAAGGTATAGATAATACACATAATCCTGAATTTACTTCGTGTGAATTTGGTTGGGCATATGCT	0
KRS21GGC	TATGAAATTGGTAAAGTATTTAGAAATGAAGGTATAGATAATACACATAATCCTGAATTTACTTCGTGTGAATTTGGCTGGGCATATGCT	0
KRS21GGA	TATGAAATTGGTAAAGTATTTAGAAATGAAGGTATAGATAATACACATAATCCTGAATTTACTTCGTGTGAATTTGGATGGGCATATGCT	0
KRS21GGG	TATGAAATTGGTAAAGTATTTAGAAATGAAGGTATAGATAATACACATAATCCTGAATTTACTTCGTGTGAATTTGGGTGGGCATATGCT	0
